speaker_ID,sex,subset,start,end,length,origin_path
121,F,test-clean,7680,26624,18944,test-clean/121/123852/121-123852-0001.flac
672,M,test-clean,0,20560,20560,test-clean/672/122797/672-122797-0033.flac
260,M,test-clean,6656,27840,21184,test-clean/260/123440/260-123440-0001.flac
4970,F,test-clean,8704,30720,22016,test-clean/4970/29093/4970-29093-0016.flac
2094,F,test-clean,0,22720,22720,test-clean/2094/142345/2094-142345-0041.flac
2830,M,test-clean,0,23760,23760,test-clean/2830/3980/2830-3980-0026.flac
121,F,test-clean,7680,31744,24064,test-clean/121/127105/121-127105-0004.flac
237,F,test-clean,0,26080,26080,test-clean/237/134500/237-134500-0025.flac
260,M,test-clean,2048,28880,26832,test-clean/260/123288/260-123288-0014.flac
7127,M,test-clean,0,26960,26960,test-clean/7127/75947/7127-75947-0012.flac
3575,F,test-clean,0,27120,27120,test-clean/3575/170457/3575-170457-0016.flac
4970,F,test-clean,4608,32256,27648,test-clean/4970/29093/4970-29093-0021.flac
8555,F,test-clean,2048,30208,28160,test-clean/8555/284447/8555-284447-0011.flac
1995,F,test-clean,3072,31280,28208,test-clean/1995/1837/1995-1837-0008.flac
121,F,test-clean,4096,32768,28672,test-clean/121/127105/121-127105-0014.flac
121,F,test-clean,3072,31744,28672,test-clean/121/127105/121-127105-0021.flac
4446,F,test-clean,0,28720,28720,test-clean/4446/2273/4446-2273-0031.flac
237,F,test-clean,0,28960,28960,test-clean/237/134500/237-134500-0001.flac
8555,F,test-clean,0,28960,28960,test-clean/8555/292519/8555-292519-0002.flac
6930,M,test-clean,0,29040,29040,test-clean/6930/81414/6930-81414-0005.flac
61,M,test-clean,0,29120,29120,test-clean/61/70968/61-70968-0058.flac
2830,M,test-clean,0,29200,29200,test-clean/2830/3980/2830-3980-0059.flac
121,F,test-clean,3584,33280,29696,test-clean/121/121726/121-121726-0013.flac
5105,M,test-clean,0,30080,30080,test-clean/5105/28241/5105-28241-0007.flac
121,F,test-clean,5120,35328,30208,test-clean/121/127105/121-127105-0033.flac
7021,M,test-clean,2048,32256,30208,test-clean/7021/79730/7021-79730-0000.flac
6930,M,test-clean,0,30320,30320,test-clean/6930/76324/6930-76324-0022.flac
4446,F,test-clean,0,30400,30400,test-clean/4446/2275/4446-2275-0039.flac
121,F,test-clean,2048,32480,30432,test-clean/121/127105/121-127105-0016.flac
5683,F,test-clean,0,30480,30480,test-clean/5683/32879/5683-32879-0025.flac
7127,M,test-clean,0,30480,30480,test-clean/7127/75947/7127-75947-0004.flac
2094,F,test-clean,0,30480,30480,test-clean/2094/142345/2094-142345-0046.flac
1188,M,test-clean,0,30640,30640,test-clean/1188/133604/1188-133604-0030.flac
7127,M,test-clean,0,30720,30720,test-clean/7127/75947/7127-75947-0031.flac
6930,M,test-clean,0,31040,31040,test-clean/6930/75918/6930-75918-0012.flac
2830,M,test-clean,0,31120,31120,test-clean/2830/3979/2830-3979-0004.flac
4446,F,test-clean,0,31200,31200,test-clean/4446/2273/4446-2273-0026.flac
260,M,test-clean,1536,32768,31232,test-clean/260/123288/260-123288-0023.flac
672,M,test-clean,0,31360,31360,test-clean/672/122797/672-122797-0037.flac
2830,M,test-clean,0,31600,31600,test-clean/2830/3980/2830-3980-0043.flac
8463,F,test-clean,0,31600,31600,test-clean/8463/294828/8463-294828-0024.flac
1580,F,test-clean,0,31680,31680,test-clean/1580/141083/1580-141083-0051.flac
4970,F,test-clean,0,31680,31680,test-clean/4970/29095/4970-29095-0013.flac
7021,M,test-clean,7168,38912,31744,test-clean/7021/79759/7021-79759-0001.flac
7021,M,test-clean,7168,38912,31744,test-clean/7021/79730/7021-79730-0002.flac
7127,M,test-clean,0,31744,31744,test-clean/7127/75947/7127-75947-0005.flac
8463,F,test-clean,0,31840,31840,test-clean/8463/294828/8463-294828-0025.flac
4507,F,test-clean,0,31920,31920,test-clean/4507/16021/4507-16021-0027.flac
5142,F,test-clean,0,31920,31920,test-clean/5142/33396/5142-33396-0039.flac
1580,F,test-clean,0,32000,32000,test-clean/1580/141084/1580-141084-0017.flac
5142,F,test-clean,0,32080,32080,test-clean/5142/33396/5142-33396-0000.flac
5683,F,test-clean,0,32160,32160,test-clean/5683/32879/5683-32879-0015.flac
121,F,test-clean,1024,33280,32256,test-clean/121/127105/121-127105-0030.flac
7021,M,test-clean,3072,35328,32256,test-clean/7021/85628/7021-85628-0014.flac
61,M,test-clean,0,32320,32320,test-clean/61/70970/61-70970-0005.flac
672,M,test-clean,0,32320,32320,test-clean/672/122797/672-122797-0049.flac
1580,F,test-clean,0,32320,32320,test-clean/1580/141084/1580-141084-0007.flac
2830,M,test-clean,0,32400,32400,test-clean/2830/3980/2830-3980-0002.flac
237,F,test-clean,0,32560,32560,test-clean/237/134493/237-134493-0007.flac
6829,F,test-clean,0,32640,32640,test-clean/6829/68769/6829-68769-0029.flac
7021,M,test-clean,0,32768,32768,test-clean/7021/79740/7021-79740-0005.flac
61,M,test-clean,0,32800,32800,test-clean/61/70968/61-70968-0038.flac
1580,F,test-clean,0,32960,32960,test-clean/1580/141084/1580-141084-0022.flac
4446,F,test-clean,0,32960,32960,test-clean/4446/2275/4446-2275-0003.flac
237,F,test-clean,0,33040,33040,test-clean/237/134500/237-134500-0029.flac
1580,F,test-clean,0,33040,33040,test-clean/1580/141084/1580-141084-0043.flac
1995,F,test-clean,3584,36864,33280,test-clean/1995/1826/1995-1826-0006.flac
1995,F,test-clean,2048,35328,33280,test-clean/1995/1836/1995-1836-0002.flac
1995,F,test-clean,2560,35840,33280,test-clean/1995/1837/1995-1837-0028.flac
1089,M,test-clean,0,33360,33360,test-clean/1089/134691/1089-134691-0000.flac
4446,F,test-clean,0,33440,33440,test-clean/4446/2275/4446-2275-0037.flac
4446,F,test-clean,0,33440,33440,test-clean/4446/2275/4446-2275-0009.flac
4446,F,test-clean,0,33600,33600,test-clean/4446/2271/4446-2271-0007.flac
2830,M,test-clean,0,33680,33680,test-clean/2830/3979/2830-3979-0005.flac
5142,F,test-clean,0,33760,33760,test-clean/5142/33396/5142-33396-0013.flac
5142,F,test-clean,0,33760,33760,test-clean/5142/33396/5142-33396-0008.flac
8555,F,test-clean,0,33760,33760,test-clean/8555/284447/8555-284447-0016.flac
4507,F,test-clean,0,33760,33760,test-clean/4507/16021/4507-16021-0006.flac
4446,F,test-clean,0,33760,33760,test-clean/4446/2275/4446-2275-0004.flac
3575,F,test-clean,0,33760,33760,test-clean/3575/170457/3575-170457-0002.flac
121,F,test-clean,8192,41984,33792,test-clean/121/121726/121-121726-0005.flac
260,M,test-clean,4096,37888,33792,test-clean/260/123286/260-123286-0021.flac
5639,M,test-clean,1536,35440,33904,test-clean/5639/40744/5639-40744-0008.flac
6829,F,test-clean,0,34000,34000,test-clean/6829/68771/6829-68771-0026.flac
908,M,test-clean,0,34000,34000,test-clean/908/31957/908-31957-0000.flac
1284,F,test-clean,0,34080,34080,test-clean/1284/1180/1284-1180-0016.flac
7176,M,test-clean,0,34080,34080,test-clean/7176/88083/7176-88083-0027.flac
4507,F,test-clean,0,34160,34160,test-clean/4507/16021/4507-16021-0004.flac
6829,F,test-clean,0,34160,34160,test-clean/6829/68769/6829-68769-0045.flac
1580,F,test-clean,0,34160,34160,test-clean/1580/141084/1580-141084-0006.flac
5142,F,test-clean,0,34160,34160,test-clean/5142/33396/5142-33396-0029.flac
5142,F,test-clean,0,34240,34240,test-clean/5142/33396/5142-33396-0061.flac
6930,M,test-clean,0,34240,34240,test-clean/6930/76324/6930-76324-0018.flac
4992,F,test-clean,0,34240,34240,test-clean/4992/41806/4992-41806-0010.flac
8455,M,test-clean,0,34240,34240,test-clean/8455/210777/8455-210777-0032.flac
1995,F,test-clean,1024,35328,34304,test-clean/1995/1826/1995-1826-0010.flac
260,M,test-clean,3072,37376,34304,test-clean/260/123286/260-123286-0012.flac
7021,M,test-clean,0,34304,34304,test-clean/7021/85628/7021-85628-0024.flac
4970,F,test-clean,6656,40960,34304,test-clean/4970/29093/4970-29093-0017.flac
121,F,test-clean,1536,35840,34304,test-clean/121/127105/121-127105-0009.flac
1580,F,test-clean,0,34320,34320,test-clean/1580/141084/1580-141084-0030.flac
61,M,test-clean,0,34400,34400,test-clean/61/70970/61-70970-0008.flac
8555,F,test-clean,0,34480,34480,test-clean/8555/284449/8555-284449-0014.flac
7021,M,test-clean,0,34480,34480,test-clean/7021/85628/7021-85628-0017.flac
6930,M,test-clean,0,34560,34560,test-clean/6930/81414/6930-81414-0016.flac
4446,F,test-clean,0,34560,34560,test-clean/4446/2275/4446-2275-0025.flac
7176,M,test-clean,0,34560,34560,test-clean/7176/92135/7176-92135-0010.flac
5142,F,test-clean,0,34640,34640,test-clean/5142/33396/5142-33396-0016.flac
260,M,test-clean,0,34640,34640,test-clean/260/123440/260-123440-0000.flac
5142,F,test-clean,0,34641,34641,test-clean/5142/36377/5142-36377-0011.flac
61,M,test-clean,0,34720,34720,test-clean/61/70968/61-70968-0059.flac
7127,M,test-clean,0,34720,34720,test-clean/7127/75946/7127-75946-0001.flac
1089,M,test-clean,0,34800,34800,test-clean/1089/134691/1089-134691-0003.flac
6829,F,test-clean,0,34800,34800,test-clean/6829/68769/6829-68769-0042.flac
7127,M,test-clean,0,34800,34800,test-clean/7127/75947/7127-75947-0020.flac
8463,F,test-clean,0,34879,34879,test-clean/8463/294825/8463-294825-0011.flac
237,F,test-clean,0,34880,34880,test-clean/237/134500/237-134500-0017.flac
237,F,test-clean,0,34880,34880,test-clean/237/134500/237-134500-0020.flac
4507,F,test-clean,0,35040,35040,test-clean/4507/16021/4507-16021-0044.flac
5683,F,test-clean,0,35040,35040,test-clean/5683/32865/5683-32865-0000.flac
4970,F,test-clean,4096,39424,35328,test-clean/4970/29095/4970-29095-0010.flac
260,M,test-clean,5120,40448,35328,test-clean/260/123288/260-123288-0028.flac
2094,F,test-clean,0,35360,35360,test-clean/2094/142345/2094-142345-0047.flac
5142,F,test-clean,0,35440,35440,test-clean/5142/33396/5142-33396-0066.flac
5142,F,test-clean,0,35440,35440,test-clean/5142/36586/5142-36586-0001.flac
5142,F,test-clean,0,35440,35440,test-clean/5142/33396/5142-33396-0004.flac
1089,M,test-clean,0,35440,35440,test-clean/1089/134691/1089-134691-0024.flac
237,F,test-clean,0,35520,35520,test-clean/237/134500/237-134500-0009.flac
1089,M,test-clean,0,35600,35600,test-clean/1089/134686/1089-134686-0014.flac
1580,F,test-clean,0,35600,35600,test-clean/1580/141084/1580-141084-0013.flac
237,F,test-clean,0,35600,35600,test-clean/237/134500/237-134500-0004.flac
5142,F,test-clean,0,35600,35600,test-clean/5142/33396/5142-33396-0005.flac
7176,M,test-clean,0,35680,35680,test-clean/7176/92135/7176-92135-0033.flac
5142,F,test-clean,0,35760,35760,test-clean/5142/33396/5142-33396-0027.flac
7176,M,test-clean,0,35760,35760,test-clean/7176/92135/7176-92135-0030.flac
237,F,test-clean,0,35840,35840,test-clean/237/126133/237-126133-0020.flac
260,M,test-clean,3584,39424,35840,test-clean/260/123286/260-123286-0010.flac
5639,M,test-clean,512,36352,35840,test-clean/5639/40744/5639-40744-0009.flac
1320,M,test-clean,0,35840,35840,test-clean/1320/122617/1320-122617-0038.flac
260,M,test-clean,8192,44032,35840,test-clean/260/123286/260-123286-0020.flac
8455,M,test-clean,0,36160,36160,test-clean/8455/210777/8455-210777-0063.flac
2094,F,test-clean,0,36160,36160,test-clean/2094/142345/2094-142345-0016.flac
4446,F,test-clean,0,36240,36240,test-clean/4446/2271/4446-2271-0023.flac
2830,M,test-clean,0,36320,36320,test-clean/2830/3980/2830-3980-0027.flac
8555,F,test-clean,0,36400,36400,test-clean/8555/284447/8555-284447-0012.flac
5683,F,test-clean,0,36400,36400,test-clean/5683/32866/5683-32866-0029.flac
1995,F,test-clean,3584,40000,36416,test-clean/1995/1826/1995-1826-0014.flac
2094,F,test-clean,0,36480,36480,test-clean/2094/142345/2094-142345-0022.flac
1580,F,test-clean,0,36480,36480,test-clean/1580/141083/1580-141083-0017.flac
5105,M,test-clean,0,36800,36800,test-clean/5105/28240/5105-28240-0020.flac
237,F,test-clean,0,36880,36880,test-clean/237/134493/237-134493-0008.flac
5105,M,test-clean,0,36960,36960,test-clean/5105/28241/5105-28241-0010.flac
4446,F,test-clean,0,37040,37040,test-clean/4446/2275/4446-2275-0018.flac
4446,F,test-clean,0,37200,37200,test-clean/4446/2271/4446-2271-0022.flac
6829,F,test-clean,0,37200,37200,test-clean/6829/68769/6829-68769-0047.flac
5142,F,test-clean,0,37360,37360,test-clean/5142/36586/5142-36586-0002.flac
7176,M,test-clean,0,37360,37360,test-clean/7176/88083/7176-88083-0015.flac
908,M,test-clean,0,37360,37360,test-clean/908/31957/908-31957-0011.flac
61,M,test-clean,0,37360,37360,test-clean/61/70970/61-70970-0006.flac
5142,F,test-clean,0,37376,37376,test-clean/5142/33396/5142-33396-0045.flac
8463,F,test-clean,0,37440,37440,test-clean/8463/294828/8463-294828-0004.flac
6930,M,test-clean,0,37440,37440,test-clean/6930/81414/6930-81414-0017.flac
5683,F,test-clean,0,37440,37440,test-clean/5683/32866/5683-32866-0026.flac
1580,F,test-clean,0,37600,37600,test-clean/1580/141084/1580-141084-0046.flac
8463,F,test-clean,0,37600,37600,test-clean/8463/294825/8463-294825-0017.flac
8463,F,test-clean,0,37680,37680,test-clean/8463/294828/8463-294828-0022.flac
4970,F,test-clean,0,37760,37760,test-clean/4970/29095/4970-29095-0015.flac
5683,F,test-clean,0,37920,37920,test-clean/5683/32879/5683-32879-0024.flac
2830,M,test-clean,0,37920,37920,test-clean/2830/3980/2830-3980-0016.flac
1580,F,test-clean,0,38000,38000,test-clean/1580/141084/1580-141084-0025.flac
2300,M,test-clean,0,38160,38160,test-clean/2300/131720/2300-131720-0039.flac
4446,F,test-clean,0,38160,38160,test-clean/4446/2271/4446-2271-0002.flac
2094,F,test-clean,0,38160,38160,test-clean/2094/142345/2094-142345-0040.flac
6829,F,test-clean,0,38240,38240,test-clean/6829/68771/6829-68771-0017.flac
237,F,test-clean,0,38240,38240,test-clean/237/134500/237-134500-0007.flac
4446,F,test-clean,0,38240,38240,test-clean/4446/2273/4446-2273-0014.flac
237,F,test-clean,0,38240,38240,test-clean/237/134500/237-134500-0005.flac
4446,F,test-clean,0,38320,38320,test-clean/4446/2275/4446-2275-0024.flac
1188,M,test-clean,0,38400,38400,test-clean/1188/133604/1188-133604-0006.flac
7176,M,test-clean,0,38480,38480,test-clean/7176/92135/7176-92135-0019.flac
61,M,test-clean,0,38480,38480,test-clean/61/70968/61-70968-0018.flac
5142,F,test-clean,0,38640,38640,test-clean/5142/36377/5142-36377-0019.flac
8463,F,test-clean,0,38640,38640,test-clean/8463/294825/8463-294825-0014.flac
7176,M,test-clean,0,38800,38800,test-clean/7176/92135/7176-92135-0004.flac
4970,F,test-clean,4096,43008,38912,test-clean/4970/29093/4970-29093-0000.flac
8555,F,test-clean,0,38960,38960,test-clean/8555/292519/8555-292519-0014.flac
4446,F,test-clean,0,38960,38960,test-clean/4446/2275/4446-2275-0011.flac
2094,F,test-clean,0,38960,38960,test-clean/2094/142345/2094-142345-0020.flac
237,F,test-clean,0,38960,38960,test-clean/237/134500/237-134500-0038.flac
7127,M,test-clean,0,39040,39040,test-clean/7127/75947/7127-75947-0036.flac
8463,F,test-clean,0,39040,39040,test-clean/8463/294828/8463-294828-0005.flac
5639,M,test-clean,3584,42640,39056,test-clean/5639/40744/5639-40744-0011.flac
2094,F,test-clean,0,39280,39280,test-clean/2094/142345/2094-142345-0042.flac
1995,F,test-clean,1536,40960,39424,test-clean/1995/1826/1995-1826-0008.flac
260,M,test-clean,8192,47680,39488,test-clean/260/123286/260-123286-0014.flac
6829,F,test-clean,0,39600,39600,test-clean/6829/68771/6829-68771-0034.flac
1580,F,test-clean,0,39600,39600,test-clean/1580/141084/1580-141084-0036.flac
4446,F,test-clean,0,39600,39600,test-clean/4446/2275/4446-2275-0017.flac
2830,M,test-clean,0,39680,39680,test-clean/2830/3980/2830-3980-0003.flac
1580,F,test-clean,0,39760,39760,test-clean/1580/141084/1580-141084-0012.flac
260,M,test-clean,5120,45056,39936,test-clean/260/123286/260-123286-0001.flac
260,M,test-clean,0,39936,39936,test-clean/260/123288/260-123288-0021.flac
4970,F,test-clean,1024,40960,39936,test-clean/4970/29095/4970-29095-0000.flac
6829,F,test-clean,0,40080,40080,test-clean/6829/68769/6829-68769-0038.flac
260,M,test-clean,7168,47280,40112,test-clean/260/123288/260-123288-0019.flac
8555,F,test-clean,0,40160,40160,test-clean/8555/284449/8555-284449-0010.flac
4446,F,test-clean,0,40160,40160,test-clean/4446/2275/4446-2275-0014.flac
908,M,test-clean,0,40160,40160,test-clean/908/31957/908-31957-0010.flac
1580,F,test-clean,0,40240,40240,test-clean/1580/141084/1580-141084-0005.flac
6829,F,test-clean,0,40240,40240,test-clean/6829/68771/6829-68771-0031.flac
5142,F,test-clean,0,40240,40240,test-clean/5142/33396/5142-33396-0063.flac
8455,M,test-clean,0,40320,40320,test-clean/8455/210777/8455-210777-0054.flac
5142,F,test-clean,0,40400,40400,test-clean/5142/36600/5142-36600-0000.flac
2830,M,test-clean,0,40400,40400,test-clean/2830/3980/2830-3980-0014.flac
6930,M,test-clean,0,40480,40480,test-clean/6930/81414/6930-81414-0025.flac
6829,F,test-clean,0,40480,40480,test-clean/6829/68769/6829-68769-0037.flac
5142,F,test-clean,0,40560,40560,test-clean/5142/33396/5142-33396-0047.flac
8455,M,test-clean,0,40640,40640,test-clean/8455/210777/8455-210777-0047.flac
672,M,test-clean,0,40640,40640,test-clean/672/122797/672-122797-0011.flac
260,M,test-clean,5632,46400,40768,test-clean/260/123288/260-123288-0020.flac
61,M,test-clean,0,40800,40800,test-clean/61/70970/61-70970-0017.flac
8555,F,test-clean,0,40880,40880,test-clean/8555/284449/8555-284449-0005.flac
672,M,test-clean,0,40880,40880,test-clean/672/122797/672-122797-0014.flac
61,M,test-clean,0,40880,40880,test-clean/61/70968/61-70968-0062.flac
237,F,test-clean,0,40880,40880,test-clean/237/134500/237-134500-0035.flac
121,F,test-clean,2560,43520,40960,test-clean/121/127105/121-127105-0018.flac
7176,M,test-clean,0,41040,41040,test-clean/7176/92135/7176-92135-0021.flac
121,F,test-clean,3072,44160,41088,test-clean/121/127105/121-127105-0008.flac
6829,F,test-clean,0,41120,41120,test-clean/6829/68769/6829-68769-0046.flac
237,F,test-clean,0,41200,41200,test-clean/237/134500/237-134500-0042.flac
6930,M,test-clean,0,41200,41200,test-clean/6930/76324/6930-76324-0019.flac
5683,F,test-clean,0,41280,41280,test-clean/5683/32865/5683-32865-0001.flac
1580,F,test-clean,0,41360,41360,test-clean/1580/141083/1580-141083-0028.flac
8455,M,test-clean,0,41440,41440,test-clean/8455/210777/8455-210777-0068.flac
6829,F,test-clean,0,41440,41440,test-clean/6829/68769/6829-68769-0043.flac
4507,F,test-clean,0,41440,41440,test-clean/4507/16021/4507-16021-0000.flac
4446,F,test-clean,0,41520,41520,test-clean/4446/2271/4446-2271-0015.flac
121,F,test-clean,1536,43120,41584,test-clean/121/127105/121-127105-0017.flac
7021,M,test-clean,6656,48320,41664,test-clean/7021/85628/7021-85628-0000.flac
1580,F,test-clean,0,41680,41680,test-clean/1580/141083/1580-141083-0047.flac
61,M,test-clean,0,41760,41760,test-clean/61/70968/61-70968-0012.flac
3729,F,test-clean,0,41760,41760,test-clean/3729/6852/3729-6852-0015.flac
672,M,test-clean,0,41760,41760,test-clean/672/122797/672-122797-0028.flac
6829,F,test-clean,0,41760,41760,test-clean/6829/68771/6829-68771-0021.flac
5142,F,test-clean,0,41840,41840,test-clean/5142/33396/5142-33396-0060.flac
4446,F,test-clean,0,41840,41840,test-clean/4446/2275/4446-2275-0044.flac
5683,F,test-clean,0,41840,41840,test-clean/5683/32865/5683-32865-0014.flac
2830,M,test-clean,0,41920,41920,test-clean/2830/3980/2830-3980-0040.flac
4446,F,test-clean,0,42000,42000,test-clean/4446/2273/4446-2273-0013.flac
4507,F,test-clean,0,42080,42080,test-clean/4507/16021/4507-16021-0007.flac
1580,F,test-clean,0,42080,42080,test-clean/1580/141084/1580-141084-0035.flac
1221,F,test-clean,0,42080,42080,test-clean/1221/135766/1221-135766-0015.flac
4446,F,test-clean,0,42160,42160,test-clean/4446/2275/4446-2275-0045.flac
5142,F,test-clean,0,42160,42160,test-clean/5142/33396/5142-33396-0017.flac
7127,M,test-clean,0,42160,42160,test-clean/7127/75946/7127-75946-0019.flac
1995,F,test-clean,0,42160,42160,test-clean/1995/1837/1995-1837-0005.flac
2094,F,test-clean,0,42240,42240,test-clean/2094/142345/2094-142345-0004.flac
5683,F,test-clean,0,42320,42320,test-clean/5683/32866/5683-32866-0000.flac
8463,F,test-clean,0,42400,42400,test-clean/8463/294828/8463-294828-0008.flac
61,M,test-clean,0,42400,42400,test-clean/61/70968/61-70968-0052.flac
1580,F,test-clean,0,42480,42480,test-clean/1580/141084/1580-141084-0028.flac
2094,F,test-clean,0,42480,42480,test-clean/2094/142345/2094-142345-0055.flac
4970,F,test-clean,0,42496,42496,test-clean/4970/29095/4970-29095-0019.flac
7021,M,test-clean,0,42496,42496,test-clean/7021/85628/7021-85628-0026.flac
2094,F,test-clean,0,42560,42560,test-clean/2094/142345/2094-142345-0019.flac
6829,F,test-clean,0,42560,42560,test-clean/6829/68769/6829-68769-0041.flac
1188,M,test-clean,0,42560,42560,test-clean/1188/133604/1188-133604-0042.flac
4446,F,test-clean,0,42640,42640,test-clean/4446/2275/4446-2275-0030.flac
6829,F,test-clean,0,42640,42640,test-clean/6829/68769/6829-68769-0019.flac
7127,M,test-clean,0,42640,42640,test-clean/7127/75947/7127-75947-0017.flac
8455,M,test-clean,0,42720,42720,test-clean/8455/210777/8455-210777-0007.flac
7127,M,test-clean,0,42720,42720,test-clean/7127/75946/7127-75946-0005.flac
2830,M,test-clean,0,42800,42800,test-clean/2830/3980/2830-3980-0060.flac
672,M,test-clean,0,42800,42800,test-clean/672/122797/672-122797-0062.flac
1580,F,test-clean,0,42800,42800,test-clean/1580/141083/1580-141083-0018.flac
7729,M,test-clean,0,42800,42800,test-clean/7729/102255/7729-102255-0013.flac
1089,M,test-clean,0,42880,42880,test-clean/1089/134686/1089-134686-0003.flac
2830,M,test-clean,0,42960,42960,test-clean/2830/3980/2830-3980-0015.flac
121,F,test-clean,5120,48128,43008,test-clean/121/121726/121-121726-0014.flac
1995,F,test-clean,0,43008,43008,test-clean/1995/1826/1995-1826-0004.flac
2830,M,test-clean,0,43040,43040,test-clean/2830/3980/2830-3980-0058.flac
61,M,test-clean,0,43040,43040,test-clean/61/70968/61-70968-0021.flac
6930,M,test-clean,0,43040,43040,test-clean/6930/76324/6930-76324-0010.flac
8463,F,test-clean,0,43120,43120,test-clean/8463/294828/8463-294828-0030.flac
8463,F,test-clean,0,43120,43120,test-clean/8463/294825/8463-294825-0000.flac
1284,F,test-clean,0,43200,43200,test-clean/1284/1181/1284-1181-0021.flac
2094,F,test-clean,0,43200,43200,test-clean/2094/142345/2094-142345-0007.flac
1580,F,test-clean,0,43280,43280,test-clean/1580/141083/1580-141083-0019.flac
4992,F,test-clean,0,43280,43280,test-clean/4992/41797/4992-41797-0012.flac
2094,F,test-clean,0,43360,43360,test-clean/2094/142345/2094-142345-0060.flac
4992,F,test-clean,0,43360,43360,test-clean/4992/23283/4992-23283-0001.flac
2830,M,test-clean,0,43360,43360,test-clean/2830/3980/2830-3980-0033.flac
1089,M,test-clean,0,43360,43360,test-clean/1089/134686/1089-134686-0027.flac
7729,M,test-clean,0,43360,43360,test-clean/7729/102255/7729-102255-0034.flac
5142,F,test-clean,0,43440,43440,test-clean/5142/36377/5142-36377-0012.flac
3575,F,test-clean,0,43440,43440,test-clean/3575/170457/3575-170457-0049.flac
1089,M,test-clean,0,43440,43440,test-clean/1089/134686/1089-134686-0030.flac
8455,M,test-clean,0,43440,43440,test-clean/8455/210777/8455-210777-0021.flac
260,M,test-clean,0,43440,43440,test-clean/260/123440/260-123440-0006.flac
121,F,test-clean,1536,45056,43520,test-clean/121/127105/121-127105-0010.flac
4446,F,test-clean,0,43520,43520,test-clean/4446/2275/4446-2275-0020.flac
4970,F,test-clean,6656,50176,43520,test-clean/4970/29095/4970-29095-0014.flac
6829,F,test-clean,0,43600,43600,test-clean/6829/68769/6829-68769-0013.flac
8463,F,test-clean,0,43760,43760,test-clean/8463/294828/8463-294828-0021.flac
4507,F,test-clean,0,43760,43760,test-clean/4507/16021/4507-16021-0012.flac
4446,F,test-clean,0,43840,43840,test-clean/4446/2273/4446-2273-0020.flac
4446,F,test-clean,0,43840,43840,test-clean/4446/2273/4446-2273-0017.flac
1580,F,test-clean,0,43840,43840,test-clean/1580/141083/1580-141083-0043.flac
8463,F,test-clean,0,43920,43920,test-clean/8463/294828/8463-294828-0026.flac
1580,F,test-clean,0,43920,43920,test-clean/1580/141083/1580-141083-0005.flac
5683,F,test-clean,0,43920,43920,test-clean/5683/32866/5683-32866-0023.flac
3729,F,test-clean,0,44080,44080,test-clean/3729/6852/3729-6852-0010.flac
6829,F,test-clean,0,44080,44080,test-clean/6829/68769/6829-68769-0035.flac
908,M,test-clean,0,44080,44080,test-clean/908/157963/908-157963-0002.flac
8455,M,test-clean,0,44160,44160,test-clean/8455/210777/8455-210777-0066.flac
7127,M,test-clean,0,44160,44160,test-clean/7127/75947/7127-75947-0030.flac
260,M,test-clean,5632,49840,44208,test-clean/260/123440/260-123440-0009.flac
672,M,test-clean,0,44240,44240,test-clean/672/122797/672-122797-0009.flac
5142,F,test-clean,0,44240,44240,test-clean/5142/33396/5142-33396-0030.flac
5142,F,test-clean,0,44240,44240,test-clean/5142/36377/5142-36377-0016.flac
5142,F,test-clean,0,44320,44320,test-clean/5142/33396/5142-33396-0055.flac
61,M,test-clean,0,44320,44320,test-clean/61/70968/61-70968-0044.flac
7021,M,test-clean,0,44400,44400,test-clean/7021/85628/7021-85628-0025.flac
1580,F,test-clean,0,44480,44480,test-clean/1580/141084/1580-141084-0050.flac
237,F,test-clean,0,44480,44480,test-clean/237/134500/237-134500-0030.flac
5683,F,test-clean,0,44480,44480,test-clean/5683/32865/5683-32865-0002.flac
2094,F,test-clean,0,44480,44480,test-clean/2094/142345/2094-142345-0031.flac
260,M,test-clean,0,44544,44544,test-clean/260/123288/260-123288-0000.flac
121,F,test-clean,5120,49664,44544,test-clean/121/127105/121-127105-0032.flac
1580,F,test-clean,0,44560,44560,test-clean/1580/141083/1580-141083-0048.flac
61,M,test-clean,0,44560,44560,test-clean/61/70968/61-70968-0042.flac
1995,F,test-clean,0,44640,44640,test-clean/1995/1837/1995-1837-0002.flac
4446,F,test-clean,0,44640,44640,test-clean/4446/2273/4446-2273-0011.flac
7021,M,test-clean,0,44880,44880,test-clean/7021/85628/7021-85628-0004.flac
5142,F,test-clean,0,44960,44960,test-clean/5142/33396/5142-33396-0040.flac
121,F,test-clean,0,45056,45056,test-clean/121/127105/121-127105-0015.flac
260,M,test-clean,6656,51760,45104,test-clean/260/123286/260-123286-0022.flac
6930,M,test-clean,0,45120,45120,test-clean/6930/76324/6930-76324-0007.flac
1580,F,test-clean,0,45200,45200,test-clean/1580/141083/1580-141083-0011.flac
2094,F,test-clean,0,45200,45200,test-clean/2094/142345/2094-142345-0026.flac
5683,F,test-clean,0,45280,45280,test-clean/5683/32866/5683-32866-0015.flac
5142,F,test-clean,0,45280,45280,test-clean/5142/33396/5142-33396-0041.flac
4992,F,test-clean,0,45360,45360,test-clean/4992/41797/4992-41797-0003.flac
7176,M,test-clean,0,45360,45360,test-clean/7176/92135/7176-92135-0027.flac
2094,F,test-clean,0,45360,45360,test-clean/2094/142345/2094-142345-0017.flac
2830,M,test-clean,0,45440,45440,test-clean/2830/3980/2830-3980-0046.flac
3729,F,test-clean,0,45440,45440,test-clean/3729/6852/3729-6852-0030.flac
1221,F,test-clean,0,45600,45600,test-clean/1221/135767/1221-135767-0015.flac
8555,F,test-clean,0,45600,45600,test-clean/8555/292519/8555-292519-0015.flac
1580,F,test-clean,0,45680,45680,test-clean/1580/141083/1580-141083-0014.flac
237,F,test-clean,0,45760,45760,test-clean/237/134500/237-134500-0019.flac
7176,M,test-clean,0,45760,45760,test-clean/7176/92135/7176-92135-0037.flac
1580,F,test-clean,0,45760,45760,test-clean/1580/141084/1580-141084-0020.flac
8463,F,test-clean,2560,48320,45760,test-clean/8463/287645/8463-287645-0014.flac
3729,F,test-clean,0,45760,45760,test-clean/3729/6852/3729-6852-0012.flac
5683,F,test-clean,0,45840,45840,test-clean/5683/32866/5683-32866-0003.flac
237,F,test-clean,0,46000,46000,test-clean/237/134493/237-134493-0010.flac
2830,M,test-clean,0,46080,46080,test-clean/2830/3980/2830-3980-0064.flac
1284,F,test-clean,0,46160,46160,test-clean/1284/1180/1284-1180-0022.flac
7176,M,test-clean,0,46160,46160,test-clean/7176/92135/7176-92135-0011.flac
4446,F,test-clean,0,46160,46160,test-clean/4446/2273/4446-2273-0030.flac
908,M,test-clean,0,46160,46160,test-clean/908/157963/908-157963-0001.flac
5142,F,test-clean,0,46160,46160,test-clean/5142/33396/5142-33396-0050.flac
5105,M,test-clean,0,46160,46160,test-clean/5105/28240/5105-28240-0018.flac
1580,F,test-clean,0,46320,46320,test-clean/1580/141084/1580-141084-0044.flac
672,M,test-clean,0,46400,46400,test-clean/672/122797/672-122797-0035.flac
5142,F,test-clean,0,46400,46400,test-clean/5142/33396/5142-33396-0062.flac
4446,F,test-clean,0,46480,46480,test-clean/4446/2275/4446-2275-0036.flac
4446,F,test-clean,0,46480,46480,test-clean/4446/2271/4446-2271-0006.flac
2830,M,test-clean,0,46560,46560,test-clean/2830/3980/2830-3980-0021.flac
1995,F,test-clean,4608,51200,46592,test-clean/1995/1837/1995-1837-0020.flac
1995,F,test-clean,2560,49152,46592,test-clean/1995/1837/1995-1837-0021.flac
6829,F,test-clean,0,46640,46640,test-clean/6829/68769/6829-68769-0050.flac
3575,F,test-clean,0,46720,46720,test-clean/3575/170457/3575-170457-0018.flac
4077,M,test-clean,0,46720,46720,test-clean/4077/13751/4077-13751-0019.flac
1188,M,test-clean,0,46800,46800,test-clean/1188/133604/1188-133604-0035.flac
61,M,test-clean,0,46800,46800,test-clean/61/70968/61-70968-0031.flac
6930,M,test-clean,0,46880,46880,test-clean/6930/81414/6930-81414-0018.flac
4507,F,test-clean,0,46880,46880,test-clean/4507/16021/4507-16021-0019.flac
61,M,test-clean,0,46959,46959,test-clean/61/70968/61-70968-0036.flac
8463,F,test-clean,0,46960,46960,test-clean/8463/294825/8463-294825-0018.flac
5105,M,test-clean,0,46960,46960,test-clean/5105/28240/5105-28240-0010.flac
61,M,test-clean,0,46960,46960,test-clean/61/70968/61-70968-0006.flac
4446,F,test-clean,0,47040,47040,test-clean/4446/2273/4446-2273-0006.flac
6930,M,test-clean,0,47040,47040,test-clean/6930/75918/6930-75918-0013.flac
7021,M,test-clean,1536,48640,47104,test-clean/7021/79740/7021-79740-0012.flac
8463,F,test-clean,0,47120,47120,test-clean/8463/294828/8463-294828-0018.flac
5683,F,test-clean,0,47200,47200,test-clean/5683/32879/5683-32879-0008.flac
7176,M,test-clean,0,47200,47200,test-clean/7176/92135/7176-92135-0026.flac
672,M,test-clean,0,47280,47280,test-clean/672/122797/672-122797-0053.flac
1580,F,test-clean,0,47280,47280,test-clean/1580/141084/1580-141084-0038.flac
1995,F,test-clean,0,47280,47280,test-clean/1995/1837/1995-1837-0006.flac
5105,M,test-clean,0,47360,47360,test-clean/5105/28240/5105-28240-0013.flac
3729,F,test-clean,0,47360,47360,test-clean/3729/6852/3729-6852-0021.flac
1580,F,test-clean,0,47440,47440,test-clean/1580/141084/1580-141084-0037.flac
7127,M,test-clean,0,47440,47440,test-clean/7127/75947/7127-75947-0034.flac
4992,F,test-clean,0,47440,47440,test-clean/4992/23283/4992-23283-0006.flac
61,M,test-clean,0,47520,47520,test-clean/61/70968/61-70968-0002.flac
2830,M,test-clean,0,47520,47520,test-clean/2830/3980/2830-3980-0034.flac
4507,F,test-clean,0,47600,47600,test-clean/4507/16021/4507-16021-0041.flac
237,F,test-clean,0,47600,47600,test-clean/237/134493/237-134493-0009.flac
4446,F,test-clean,0,47680,47680,test-clean/4446/2275/4446-2275-0015.flac
4446,F,test-clean,0,47680,47680,test-clean/4446/2273/4446-2273-0012.flac
7176,M,test-clean,0,47760,47760,test-clean/7176/92135/7176-92135-0029.flac
3575,F,test-clean,0,47840,47840,test-clean/3575/170457/3575-170457-0001.flac
1995,F,test-clean,1536,49440,47904,test-clean/1995/1826/1995-1826-0003.flac
4446,F,test-clean,0,47920,47920,test-clean/4446/2275/4446-2275-0027.flac
5105,M,test-clean,0,47920,47920,test-clean/5105/28241/5105-28241-0014.flac
7021,M,test-clean,4096,52080,47984,test-clean/7021/85628/7021-85628-0019.flac
3729,F,test-clean,0,48000,48000,test-clean/3729/6852/3729-6852-0027.flac
3575,F,test-clean,0,48000,48000,test-clean/3575/170457/3575-170457-0052.flac
3729,F,test-clean,0,48000,48000,test-clean/3729/6852/3729-6852-0025.flac
8455,M,test-clean,0,48000,48000,test-clean/8455/210777/8455-210777-0026.flac
2094,F,test-clean,0,48080,48080,test-clean/2094/142345/2094-142345-0045.flac
2830,M,test-clean,0,48320,48320,test-clean/2830/3980/2830-3980-0042.flac
61,M,test-clean,0,48320,48320,test-clean/61/70968/61-70968-0048.flac
1188,M,test-clean,0,48320,48320,test-clean/1188/133604/1188-133604-0013.flac
6930,M,test-clean,0,48400,48400,test-clean/6930/76324/6930-76324-0000.flac
672,M,test-clean,0,48480,48480,test-clean/672/122797/672-122797-0065.flac
3575,F,test-clean,0,48480,48480,test-clean/3575/170457/3575-170457-0032.flac
6930,M,test-clean,0,48560,48560,test-clean/6930/75918/6930-75918-0010.flac
4970,F,test-clean,0,48640,48640,test-clean/4970/29095/4970-29095-0008.flac
260,M,test-clean,0,48640,48640,test-clean/260/123286/260-123286-0024.flac
61,M,test-clean,0,48720,48720,test-clean/61/70970/61-70970-0010.flac
672,M,test-clean,0,48800,48800,test-clean/672/122797/672-122797-0029.flac
237,F,test-clean,0,48800,48800,test-clean/237/134500/237-134500-0026.flac
8455,M,test-clean,0,48800,48800,test-clean/8455/210777/8455-210777-0062.flac
4446,F,test-clean,0,48880,48880,test-clean/4446/2275/4446-2275-0031.flac
5683,F,test-clean,0,48960,48960,test-clean/5683/32865/5683-32865-0016.flac
237,F,test-clean,0,48960,48960,test-clean/237/134500/237-134500-0023.flac
6829,F,test-clean,0,49040,49040,test-clean/6829/68769/6829-68769-0027.flac
5105,M,test-clean,0,49120,49120,test-clean/5105/28240/5105-28240-0014.flac
5142,F,test-clean,0,49120,49120,test-clean/5142/33396/5142-33396-0056.flac
260,M,test-clean,0,49120,49120,test-clean/260/123440/260-123440-0017.flac
1995,F,test-clean,3584,52720,49136,test-clean/1995/1826/1995-1826-0025.flac
6930,M,test-clean,0,49200,49200,test-clean/6930/81414/6930-81414-0026.flac
6829,F,test-clean,0,49200,49200,test-clean/6829/68769/6829-68769-0002.flac
5142,F,test-clean,0,49200,49200,test-clean/5142/33396/5142-33396-0026.flac
237,F,test-clean,0,49200,49200,test-clean/237/134500/237-134500-0034.flac
5142,F,test-clean,0,49200,49200,test-clean/5142/33396/5142-33396-0057.flac
4446,F,test-clean,0,49280,49280,test-clean/4446/2275/4446-2275-0034.flac
908,M,test-clean,0,49280,49280,test-clean/908/157963/908-157963-0003.flac
8555,F,test-clean,0,49280,49280,test-clean/8555/292519/8555-292519-0011.flac
6930,M,test-clean,0,49360,49360,test-clean/6930/76324/6930-76324-0026.flac
8455,M,test-clean,0,49360,49360,test-clean/8455/210777/8455-210777-0029.flac
1580,F,test-clean,0,49360,49360,test-clean/1580/141083/1580-141083-0050.flac
1089,M,test-clean,0,49440,49440,test-clean/1089/134691/1089-134691-0018.flac
4446,F,test-clean,0,49520,49520,test-clean/4446/2273/4446-2273-0007.flac
1221,F,test-clean,0,49520,49520,test-clean/1221/135767/1221-135767-0008.flac
260,M,test-clean,4608,54160,49552,test-clean/260/123440/260-123440-0007.flac
1995,F,test-clean,0,49600,49600,test-clean/1995/1837/1995-1837-0017.flac
8455,M,test-clean,0,49600,49600,test-clean/8455/210777/8455-210777-0010.flac
121,F,test-clean,8192,57856,49664,test-clean/121/121726/121-121726-0004.flac
8555,F,test-clean,0,49664,49664,test-clean/8555/284447/8555-284447-0009.flac
260,M,test-clean,0,49680,49680,test-clean/260/123440/260-123440-0005.flac
3575,F,test-clean,0,49680,49680,test-clean/3575/170457/3575-170457-0004.flac
4507,F,test-clean,0,49760,49760,test-clean/4507/16021/4507-16021-0058.flac
4446,F,test-clean,0,49840,49840,test-clean/4446/2273/4446-2273-0019.flac
4446,F,test-clean,0,49920,49920,test-clean/4446/2273/4446-2273-0036.flac
4992,F,test-clean,0,49920,49920,test-clean/4992/23283/4992-23283-0002.flac
1580,F,test-clean,0,50000,50000,test-clean/1580/141084/1580-141084-0019.flac
7176,M,test-clean,0,50000,50000,test-clean/7176/92135/7176-92135-0039.flac
61,M,test-clean,0,50160,50160,test-clean/61/70968/61-70968-0051.flac
61,M,test-clean,0,50160,50160,test-clean/61/70970/61-70970-0032.flac
61,M,test-clean,0,50160,50160,test-clean/61/70970/61-70970-0012.flac
4446,F,test-clean,0,50160,50160,test-clean/4446/2271/4446-2271-0010.flac
1995,F,test-clean,3072,53248,50176,test-clean/1995/1837/1995-1837-0022.flac
4970,F,test-clean,6144,56320,50176,test-clean/4970/29093/4970-29093-0008.flac
6829,F,test-clean,0,50240,50240,test-clean/6829/68769/6829-68769-0010.flac
8455,M,test-clean,0,50320,50320,test-clean/8455/210777/8455-210777-0043.flac
7176,M,test-clean,0,50400,50400,test-clean/7176/92135/7176-92135-0013.flac
1089,M,test-clean,0,50480,50480,test-clean/1089/134691/1089-134691-0019.flac
8455,M,test-clean,0,50480,50480,test-clean/8455/210777/8455-210777-0020.flac
2094,F,test-clean,0,50480,50480,test-clean/2094/142345/2094-142345-0018.flac
237,F,test-clean,0,50560,50560,test-clean/237/134500/237-134500-0016.flac
1284,F,test-clean,0,50560,50560,test-clean/1284/1181/1284-1181-0018.flac
4446,F,test-clean,0,50560,50560,test-clean/4446/2271/4446-2271-0024.flac
260,M,test-clean,6144,56720,50576,test-clean/260/123288/260-123288-0012.flac
2300,M,test-clean,4096,54784,50688,test-clean/2300/131720/2300-131720-0041.flac
260,M,test-clean,0,50688,50688,test-clean/260/123288/260-123288-0009.flac
7127,M,test-clean,0,50720,50720,test-clean/7127/75946/7127-75946-0011.flac
237,F,test-clean,0,50720,50720,test-clean/237/134500/237-134500-0003.flac
1995,F,test-clean,3072,54000,50928,test-clean/1995/1837/1995-1837-0011.flac
4507,F,test-clean,0,50960,50960,test-clean/4507/16021/4507-16021-0002.flac
5683,F,test-clean,0,51040,51040,test-clean/5683/32866/5683-32866-0022.flac
1995,F,test-clean,0,51120,51120,test-clean/1995/1837/1995-1837-0013.flac
8230,M,test-clean,0,51120,51120,test-clean/8230/279154/8230-279154-0003.flac
6930,M,test-clean,0,51120,51120,test-clean/6930/75918/6930-75918-0011.flac
1089,M,test-clean,0,51120,51120,test-clean/1089/134691/1089-134691-0010.flac
121,F,test-clean,1024,52224,51200,test-clean/121/127105/121-127105-0019.flac
6930,M,test-clean,0,51200,51200,test-clean/6930/76324/6930-76324-0001.flac
1284,F,test-clean,0,51200,51200,test-clean/1284/1181/1284-1181-0019.flac
3570,F,test-clean,0,51280,51280,test-clean/3570/5694/3570-5694-0012.flac
8555,F,test-clean,1024,52320,51296,test-clean/8555/284449/8555-284449-0009.flac
5142,F,test-clean,0,51600,51600,test-clean/5142/33396/5142-33396-0058.flac
6930,M,test-clean,0,51600,51600,test-clean/6930/81414/6930-81414-0021.flac
6829,F,test-clean,0,51600,51600,test-clean/6829/68769/6829-68769-0044.flac
1188,M,test-clean,0,51680,51680,test-clean/1188/133604/1188-133604-0040.flac
5142,F,test-clean,6656,58400,51744,test-clean/5142/36586/5142-36586-0000.flac
8230,M,test-clean,0,51760,51760,test-clean/8230/279154/8230-279154-0036.flac
7127,M,test-clean,0,51760,51760,test-clean/7127/75947/7127-75947-0002.flac
61,M,test-clean,0,51840,51840,test-clean/61/70970/61-70970-0030.flac
2094,F,test-clean,0,51840,51840,test-clean/2094/142345/2094-142345-0032.flac
5142,F,test-clean,0,51920,51920,test-clean/5142/33396/5142-33396-0014.flac
8555,F,test-clean,0,51920,51920,test-clean/8555/292519/8555-292519-0004.flac
260,M,test-clean,0,51920,51920,test-clean/260/123288/260-123288-0018.flac
4446,F,test-clean,0,51920,51920,test-clean/4446/2275/4446-2275-0032.flac
1089,M,test-clean,0,52000,52000,test-clean/1089/134686/1089-134686-0036.flac
8463,F,test-clean,0,52000,52000,test-clean/8463/294825/8463-294825-0015.flac
672,M,test-clean,0,52160,52160,test-clean/672/122797/672-122797-0005.flac
4970,F,test-clean,1024,53248,52224,test-clean/4970/29093/4970-29093-0004.flac
260,M,test-clean,0,52224,52224,test-clean/260/123286/260-123286-0004.flac
4970,F,test-clean,0,52224,52224,test-clean/4970/29093/4970-29093-0015.flac
1995,F,test-clean,1536,53760,52224,test-clean/1995/1837/1995-1837-0010.flac
4507,F,test-clean,0,52240,52240,test-clean/4507/16021/4507-16021-0028.flac
1580,F,test-clean,0,52240,52240,test-clean/1580/141084/1580-141084-0001.flac
237,F,test-clean,0,52320,52320,test-clean/237/134500/237-134500-0027.flac
1284,F,test-clean,0,52320,52320,test-clean/1284/1180/1284-1180-0027.flac
2830,M,test-clean,0,52320,52320,test-clean/2830/3980/2830-3980-0022.flac
1089,M,test-clean,0,52400,52400,test-clean/1089/134686/1089-134686-0001.flac
7176,M,test-clean,0,52400,52400,test-clean/7176/92135/7176-92135-0007.flac
1995,F,test-clean,2560,54960,52400,test-clean/1995/1836/1995-1836-0007.flac
7176,M,test-clean,0,52480,52480,test-clean/7176/88083/7176-88083-0008.flac
4446,F,test-clean,0,52480,52480,test-clean/4446/2275/4446-2275-0022.flac
7729,M,test-clean,0,52560,52560,test-clean/7729/102255/7729-102255-0000.flac
6829,F,test-clean,0,52640,52640,test-clean/6829/68769/6829-68769-0028.flac
4970,F,test-clean,1024,53680,52656,test-clean/4970/29095/4970-29095-0011.flac
237,F,test-clean,0,52720,52720,test-clean/237/126133/237-126133-0004.flac
4446,F,test-clean,0,52720,52720,test-clean/4446/2273/4446-2273-0002.flac
1580,F,test-clean,0,52720,52720,test-clean/1580/141083/1580-141083-0022.flac
8463,F,test-clean,0,52720,52720,test-clean/8463/294828/8463-294828-0016.flac
6930,M,test-clean,0,52720,52720,test-clean/6930/81414/6930-81414-0003.flac
121,F,test-clean,7168,59904,52736,test-clean/121/121726/121-121726-0006.flac
3729,F,test-clean,0,52800,52800,test-clean/3729/6852/3729-6852-0013.flac
5683,F,test-clean,0,52800,52800,test-clean/5683/32866/5683-32866-0008.flac
5142,F,test-clean,0,52800,52800,test-clean/5142/33396/5142-33396-0064.flac
4446,F,test-clean,0,52800,52800,test-clean/4446/2273/4446-2273-0033.flac
4446,F,test-clean,0,52800,52800,test-clean/4446/2273/4446-2273-0029.flac
4992,F,test-clean,0,52800,52800,test-clean/4992/41797/4992-41797-0016.flac
5142,F,test-clean,0,52880,52880,test-clean/5142/33396/5142-33396-0049.flac
6930,M,test-clean,0,52880,52880,test-clean/6930/81414/6930-81414-0002.flac
3729,F,test-clean,0,52880,52880,test-clean/3729/6852/3729-6852-0019.flac
7127,M,test-clean,0,52960,52960,test-clean/7127/75947/7127-75947-0006.flac
7176,M,test-clean,0,53040,53040,test-clean/7176/92135/7176-92135-0032.flac
6930,M,test-clean,0,53040,53040,test-clean/6930/75918/6930-75918-0007.flac
5142,F,test-clean,0,53040,53040,test-clean/5142/33396/5142-33396-0020.flac
5142,F,test-clean,0,53120,53120,test-clean/5142/33396/5142-33396-0025.flac
8463,F,test-clean,0,53200,53200,test-clean/8463/287645/8463-287645-0008.flac
672,M,test-clean,0,53200,53200,test-clean/672/122797/672-122797-0047.flac
1089,M,test-clean,0,53280,53280,test-clean/1089/134686/1089-134686-0033.flac
1580,F,test-clean,0,53280,53280,test-clean/1580/141083/1580-141083-0023.flac
2830,M,test-clean,0,53360,53360,test-clean/2830/3980/2830-3980-0035.flac
1221,F,test-clean,0,53520,53520,test-clean/1221/135767/1221-135767-0020.flac
1580,F,test-clean,0,53520,53520,test-clean/1580/141084/1580-141084-0018.flac
7176,M,test-clean,0,53520,53520,test-clean/7176/92135/7176-92135-0028.flac
5683,F,test-clean,0,53600,53600,test-clean/5683/32865/5683-32865-0006.flac
237,F,test-clean,0,53600,53600,test-clean/237/134500/237-134500-0011.flac
672,M,test-clean,0,53600,53600,test-clean/672/122797/672-122797-0060.flac
7127,M,test-clean,0,53680,53680,test-clean/7127/75946/7127-75946-0021.flac
260,M,test-clean,0,53760,53760,test-clean/260/123440/260-123440-0013.flac
2830,M,test-clean,0,53760,53760,test-clean/2830/3979/2830-3979-0010.flac
7021,M,test-clean,2560,56320,53760,test-clean/7021/79740/7021-79740-0009.flac
1580,F,test-clean,0,53760,53760,test-clean/1580/141084/1580-141084-0027.flac
260,M,test-clean,4608,58368,53760,test-clean/260/123286/260-123286-0008.flac
121,F,test-clean,8192,61952,53760,test-clean/121/121726/121-121726-0011.flac
5142,F,test-clean,0,53920,53920,test-clean/5142/33396/5142-33396-0009.flac
3575,F,test-clean,0,53921,53921,test-clean/3575/170457/3575-170457-0056.flac
4507,F,test-clean,0,54000,54000,test-clean/4507/16021/4507-16021-0018.flac
6930,M,test-clean,0,54080,54080,test-clean/6930/81414/6930-81414-0019.flac
7176,M,test-clean,0,54080,54080,test-clean/7176/92135/7176-92135-0035.flac
5142,F,test-clean,0,54080,54080,test-clean/5142/36377/5142-36377-0000.flac
6930,M,test-clean,0,54160,54160,test-clean/6930/76324/6930-76324-0003.flac
8463,F,test-clean,0,54240,54240,test-clean/8463/294825/8463-294825-0019.flac
1089,M,test-clean,0,54320,54320,test-clean/1089/134691/1089-134691-0015.flac
2094,F,test-clean,0,54320,54320,test-clean/2094/142345/2094-142345-0053.flac
4446,F,test-clean,0,54320,54320,test-clean/4446/2271/4446-2271-0005.flac
4446,F,test-clean,0,54400,54400,test-clean/4446/2273/4446-2273-0018.flac
61,M,test-clean,0,54480,54480,test-clean/61/70970/61-70970-0009.flac
6930,M,test-clean,0,54480,54480,test-clean/6930/76324/6930-76324-0009.flac
61,M,test-clean,0,54480,54480,test-clean/61/70970/61-70970-0014.flac
7176,M,test-clean,0,54640,54640,test-clean/7176/92135/7176-92135-0002.flac
4970,F,test-clean,8192,62880,54688,test-clean/4970/29095/4970-29095-0017.flac
2830,M,test-clean,0,54720,54720,test-clean/2830/3980/2830-3980-0012.flac
61,M,test-clean,0,54720,54720,test-clean/61/70970/61-70970-0033.flac
2830,M,test-clean,0,54720,54720,test-clean/2830/3980/2830-3980-0018.flac
2830,M,test-clean,0,54720,54720,test-clean/2830/3980/2830-3980-0049.flac
1995,F,test-clean,0,54784,54784,test-clean/1995/1826/1995-1826-0015.flac
260,M,test-clean,0,54784,54784,test-clean/260/123440/260-123440-0018.flac
8455,M,test-clean,0,54880,54880,test-clean/8455/210777/8455-210777-0048.flac
908,M,test-clean,0,55040,55040,test-clean/908/157963/908-157963-0024.flac
1089,M,test-clean,0,55040,55040,test-clean/1089/134691/1089-134691-0007.flac
1089,M,test-clean,0,55120,55120,test-clean/1089/134686/1089-134686-0035.flac
7729,M,test-clean,0,55200,55200,test-clean/7729/102255/7729-102255-0001.flac
1580,F,test-clean,0,55200,55200,test-clean/1580/141083/1580-141083-0052.flac
5142,F,test-clean,0,55280,55280,test-clean/5142/33396/5142-33396-0010.flac
4970,F,test-clean,2560,57856,55296,test-clean/4970/29095/4970-29095-0023.flac
260,M,test-clean,0,55296,55296,test-clean/260/123288/260-123288-0022.flac
2830,M,test-clean,0,55360,55360,test-clean/2830/3980/2830-3980-0020.flac
5683,F,test-clean,0,55520,55520,test-clean/5683/32866/5683-32866-0025.flac
1580,F,test-clean,0,55520,55520,test-clean/1580/141084/1580-141084-0015.flac
5142,F,test-clean,0,55520,55520,test-clean/5142/33396/5142-33396-0003.flac
5683,F,test-clean,0,55520,55520,test-clean/5683/32866/5683-32866-0001.flac
61,M,test-clean,0,55600,55600,test-clean/61/70968/61-70968-0045.flac
5142,F,test-clean,0,55680,55680,test-clean/5142/33396/5142-33396-0023.flac
1580,F,test-clean,0,55680,55680,test-clean/1580/141083/1580-141083-0030.flac
1995,F,test-clean,2048,57856,55808,test-clean/1995/1836/1995-1836-0012.flac
1320,M,test-clean,0,55840,55840,test-clean/1320/122612/1320-122612-0016.flac
2830,M,test-clean,0,55840,55840,test-clean/2830/3980/2830-3980-0044.flac
4446,F,test-clean,0,55920,55920,test-clean/4446/2271/4446-2271-0000.flac
61,M,test-clean,0,55920,55920,test-clean/61/70968/61-70968-0029.flac
3575,F,test-clean,0,55920,55920,test-clean/3575/170457/3575-170457-0034.flac
6930,M,test-clean,0,56080,56080,test-clean/6930/75918/6930-75918-0000.flac
8463,F,test-clean,0,56080,56080,test-clean/8463/294828/8463-294828-0034.flac
5142,F,test-clean,0,56080,56080,test-clean/5142/33396/5142-33396-0021.flac
5683,F,test-clean,0,56160,56160,test-clean/5683/32865/5683-32865-0003.flac
2830,M,test-clean,0,56160,56160,test-clean/2830/3980/2830-3980-0045.flac
1320,M,test-clean,0,56240,56240,test-clean/1320/122612/1320-122612-0014.flac
2094,F,test-clean,0,56320,56320,test-clean/2094/142345/2094-142345-0044.flac
260,M,test-clean,0,56320,56320,test-clean/260/123440/260-123440-0003.flac
5142,F,test-clean,0,56320,56320,test-clean/5142/33396/5142-33396-0011.flac
672,M,test-clean,0,56320,56320,test-clean/672/122797/672-122797-0059.flac
8455,M,test-clean,0,56400,56400,test-clean/8455/210777/8455-210777-0012.flac
2300,M,test-clean,3584,60000,56416,test-clean/2300/131720/2300-131720-0014.flac
8555,F,test-clean,512,56960,56448,test-clean/8555/284447/8555-284447-0022.flac
1580,F,test-clean,0,56480,56480,test-clean/1580/141083/1580-141083-0046.flac
61,M,test-clean,0,56560,56560,test-clean/61/70968/61-70968-0008.flac
1089,M,test-clean,0,56640,56640,test-clean/1089/134686/1089-134686-0016.flac
2830,M,test-clean,0,56640,56640,test-clean/2830/3980/2830-3980-0028.flac
4446,F,test-clean,0,56640,56640,test-clean/4446/2275/4446-2275-0006.flac
8463,F,test-clean,0,56720,56720,test-clean/8463/287645/8463-287645-0001.flac
6829,F,test-clean,0,56720,56720,test-clean/6829/68769/6829-68769-0017.flac
6829,F,test-clean,0,56720,56720,test-clean/6829/68769/6829-68769-0051.flac
61,M,test-clean,0,56800,56800,test-clean/61/70968/61-70968-0046.flac
61,M,test-clean,0,56800,56800,test-clean/61/70968/61-70968-0007.flac
121,F,test-clean,5120,61952,56832,test-clean/121/127105/121-127105-0036.flac
4970,F,test-clean,4608,61440,56832,test-clean/4970/29093/4970-29093-0014.flac
260,M,test-clean,5120,61952,56832,test-clean/260/123286/260-123286-0017.flac
6829,F,test-clean,0,56880,56880,test-clean/6829/68771/6829-68771-0028.flac
260,M,test-clean,4096,61040,56944,test-clean/260/123440/260-123440-0014.flac
4446,F,test-clean,0,56960,56960,test-clean/4446/2271/4446-2271-0021.flac
5142,F,test-clean,0,57040,57040,test-clean/5142/36586/5142-36586-0004.flac
61,M,test-clean,0,57040,57040,test-clean/61/70968/61-70968-0056.flac
5142,F,test-clean,0,57200,57200,test-clean/5142/33396/5142-33396-0037.flac
1580,F,test-clean,0,57200,57200,test-clean/1580/141083/1580-141083-0041.flac
4446,F,test-clean,0,57200,57200,test-clean/4446/2275/4446-2275-0028.flac
2094,F,test-clean,0,57200,57200,test-clean/2094/142345/2094-142345-0035.flac
7021,M,test-clean,0,57280,57280,test-clean/7021/85628/7021-85628-0006.flac
4446,F,test-clean,0,57440,57440,test-clean/4446/2273/4446-2273-0034.flac
4507,F,test-clean,0,57440,57440,test-clean/4507/16021/4507-16021-0008.flac
2094,F,test-clean,0,57520,57520,test-clean/2094/142345/2094-142345-0025.flac
7127,M,test-clean,0,57600,57600,test-clean/7127/75946/7127-75946-0010.flac
61,M,test-clean,0,57760,57760,test-clean/61/70968/61-70968-0001.flac
8463,F,test-clean,0,57840,57840,test-clean/8463/294828/8463-294828-0000.flac
8230,M,test-clean,0,57920,57920,test-clean/8230/279154/8230-279154-0008.flac
7127,M,test-clean,0,57920,57920,test-clean/7127/75947/7127-75947-0011.flac
1580,F,test-clean,0,58000,58000,test-clean/1580/141084/1580-141084-0045.flac
2830,M,test-clean,0,58000,58000,test-clean/2830/3979/2830-3979-0012.flac
908,M,test-clean,0,58080,58080,test-clean/908/157963/908-157963-0029.flac
8455,M,test-clean,0,58080,58080,test-clean/8455/210777/8455-210777-0025.flac
8230,M,test-clean,0,58240,58240,test-clean/8230/279154/8230-279154-0012.flac
1221,F,test-clean,0,58320,58320,test-clean/1221/135766/1221-135766-0013.flac
4446,F,test-clean,0,58400,58400,test-clean/4446/2275/4446-2275-0013.flac
6829,F,test-clean,0,58480,58480,test-clean/6829/68769/6829-68769-0014.flac
237,F,test-clean,0,58560,58560,test-clean/237/134493/237-134493-0012.flac
7176,M,test-clean,0,58560,58560,test-clean/7176/88083/7176-88083-0017.flac
5683,F,test-clean,0,58560,58560,test-clean/5683/32879/5683-32879-0001.flac
1284,F,test-clean,0,58640,58640,test-clean/1284/1180/1284-1180-0014.flac
2830,M,test-clean,0,58640,58640,test-clean/2830/3980/2830-3980-0017.flac
5142,F,test-clean,0,58720,58720,test-clean/5142/33396/5142-33396-0002.flac
4992,F,test-clean,0,58800,58800,test-clean/4992/23283/4992-23283-0015.flac
8463,F,test-clean,0,58880,58880,test-clean/8463/294825/8463-294825-0004.flac
4970,F,test-clean,1536,60416,58880,test-clean/4970/29095/4970-29095-0025.flac
4446,F,test-clean,0,59200,59200,test-clean/4446/2271/4446-2271-0003.flac
4992,F,test-clean,0,59200,59200,test-clean/4992/41806/4992-41806-0004.flac
237,F,test-clean,0,59200,59200,test-clean/237/134493/237-134493-0014.flac
1284,F,test-clean,0,59280,59280,test-clean/1284/1180/1284-1180-0013.flac
61,M,test-clean,0,59280,59280,test-clean/61/70970/61-70970-0023.flac
1188,M,test-clean,0,59280,59280,test-clean/1188/133604/1188-133604-0029.flac
8463,F,test-clean,0,59360,59360,test-clean/8463/287645/8463-287645-0009.flac
1580,F,test-clean,0,59440,59440,test-clean/1580/141083/1580-141083-0021.flac
61,M,test-clean,0,59520,59520,test-clean/61/70968/61-70968-0016.flac
1580,F,test-clean,0,59600,59600,test-clean/1580/141083/1580-141083-0039.flac
2830,M,test-clean,0,59680,59680,test-clean/2830/3980/2830-3980-0070.flac
4992,F,test-clean,0,59680,59680,test-clean/4992/41806/4992-41806-0005.flac
6930,M,test-clean,0,59680,59680,test-clean/6930/81414/6930-81414-0015.flac
2830,M,test-clean,0,59680,59680,test-clean/2830/3980/2830-3980-0000.flac
61,M,test-clean,0,59760,59760,test-clean/61/70968/61-70968-0060.flac
4446,F,test-clean,0,59760,59760,test-clean/4446/2275/4446-2275-0010.flac
672,M,test-clean,0,59840,59840,test-clean/672/122797/672-122797-0044.flac
260,M,test-clean,0,59904,59904,test-clean/260/123440/260-123440-0008.flac
7127,M,test-clean,0,59920,59920,test-clean/7127/75946/7127-75946-0023.flac
5142,F,test-clean,0,59920,59920,test-clean/5142/33396/5142-33396-0046.flac
1580,F,test-clean,0,60000,60000,test-clean/1580/141083/1580-141083-0040.flac
3570,F,test-clean,0,60080,60080,test-clean/3570/5694/3570-5694-0019.flac
8455,M,test-clean,0,60080,60080,test-clean/8455/210777/8455-210777-0067.flac
5142,F,test-clean,0,60080,60080,test-clean/5142/33396/5142-33396-0028.flac
237,F,test-clean,0,60080,60080,test-clean/237/126133/237-126133-0025.flac
4446,F,test-clean,0,60160,60160,test-clean/4446/2273/4446-2273-0027.flac
237,F,test-clean,0,60160,60160,test-clean/237/134500/237-134500-0008.flac
1995,F,test-clean,0,60160,60160,test-clean/1995/1837/1995-1837-0009.flac
260,M,test-clean,8704,68960,60256,test-clean/260/123288/260-123288-0004.flac
4077,M,test-clean,0,60320,60320,test-clean/4077/13754/4077-13754-0001.flac
5142,F,test-clean,0,60320,60320,test-clean/5142/33396/5142-33396-0043.flac
2961,F,test-clean,0,60400,60400,test-clean/2961/961/2961-961-0005.flac
121,F,test-clean,1536,61952,60416,test-clean/121/121726/121-121726-0012.flac
4446,F,test-clean,0,60480,60480,test-clean/4446/2271/4446-2271-0012.flac
672,M,test-clean,0,60480,60480,test-clean/672/122797/672-122797-0043.flac
1221,F,test-clean,0,60480,60480,test-clean/1221/135767/1221-135767-0019.flac
61,M,test-clean,0,60480,60480,test-clean/61/70970/61-70970-0019.flac
6829,F,test-clean,0,60800,60800,test-clean/6829/68771/6829-68771-0022.flac
4446,F,test-clean,0,60880,60880,test-clean/4446/2275/4446-2275-0023.flac
61,M,test-clean,0,60880,60880,test-clean/61/70968/61-70968-0039.flac
2830,M,test-clean,0,60960,60960,test-clean/2830/3980/2830-3980-0004.flac
672,M,test-clean,0,61040,61040,test-clean/672/122797/672-122797-0010.flac
4446,F,test-clean,0,61200,61200,test-clean/4446/2271/4446-2271-0019.flac
61,M,test-clean,0,61360,61360,test-clean/61/70970/61-70970-0003.flac
8455,M,test-clean,0,61360,61360,test-clean/8455/210777/8455-210777-0064.flac
1284,F,test-clean,0,61360,61360,test-clean/1284/1181/1284-1181-0002.flac
6930,M,test-clean,0,61360,61360,test-clean/6930/81414/6930-81414-0010.flac
2094,F,test-clean,0,61440,61440,test-clean/2094/142345/2094-142345-0056.flac
5639,M,test-clean,0,61440,61440,test-clean/5639/40744/5639-40744-0010.flac
4992,F,test-clean,0,61520,61520,test-clean/4992/41797/4992-41797-0005.flac
1580,F,test-clean,0,61521,61521,test-clean/1580/141083/1580-141083-0049.flac
6930,M,test-clean,0,61600,61600,test-clean/6930/81414/6930-81414-0027.flac
1284,F,test-clean,0,61680,61680,test-clean/1284/1181/1284-1181-0005.flac
1320,M,test-clean,0,61680,61680,test-clean/1320/122617/1320-122617-0022.flac
4507,F,test-clean,0,61760,61760,test-clean/4507/16021/4507-16021-0015.flac
6829,F,test-clean,0,61840,61840,test-clean/6829/68769/6829-68769-0007.flac
237,F,test-clean,0,61840,61840,test-clean/237/126133/237-126133-0008.flac
1995,F,test-clean,0,61840,61840,test-clean/1995/1837/1995-1837-0000.flac
4507,F,test-clean,0,61920,61920,test-clean/4507/16021/4507-16021-0029.flac
8224,M,test-clean,0,61920,61920,test-clean/8224/274384/8224-274384-0003.flac
7127,M,test-clean,0,62000,62000,test-clean/7127/75947/7127-75947-0019.flac
1320,M,test-clean,0,62080,62080,test-clean/1320/122612/1320-122612-0009.flac
672,M,test-clean,0,62080,62080,test-clean/672/122797/672-122797-0041.flac
8230,M,test-clean,0,62080,62080,test-clean/8230/279154/8230-279154-0032.flac
61,M,test-clean,0,62160,62160,test-clean/61/70968/61-70968-0004.flac
4507,F,test-clean,0,62160,62160,test-clean/4507/16021/4507-16021-0038.flac
2830,M,test-clean,0,62160,62160,test-clean/2830/3980/2830-3980-0009.flac
4970,F,test-clean,0,62240,62240,test-clean/4970/29095/4970-29095-0029.flac
4507,F,test-clean,0,62320,62320,test-clean/4507/16021/4507-16021-0050.flac
7021,M,test-clean,8192,70656,62464,test-clean/7021/79759/7021-79759-0003.flac
1580,F,test-clean,0,62480,62480,test-clean/1580/141083/1580-141083-0025.flac
5142,F,test-clean,0,62560,62560,test-clean/5142/36377/5142-36377-0003.flac
8463,F,test-clean,0,62560,62560,test-clean/8463/294828/8463-294828-0011.flac
908,M,test-clean,0,62640,62640,test-clean/908/31957/908-31957-0018.flac
8455,M,test-clean,0,62640,62640,test-clean/8455/210777/8455-210777-0065.flac
7176,M,test-clean,0,62720,62720,test-clean/7176/88083/7176-88083-0016.flac
8555,F,test-clean,0,62720,62720,test-clean/8555/284449/8555-284449-0006.flac
4507,F,test-clean,0,62800,62800,test-clean/4507/16021/4507-16021-0040.flac
5142,F,test-clean,0,62880,62880,test-clean/5142/33396/5142-33396-0053.flac
5683,F,test-clean,0,62880,62880,test-clean/5683/32866/5683-32866-0020.flac
2830,M,test-clean,0,62960,62960,test-clean/2830/3980/2830-3980-0024.flac
260,M,test-clean,3584,66560,62976,test-clean/260/123286/260-123286-0011.flac
121,F,test-clean,1536,64512,62976,test-clean/121/121726/121-121726-0002.flac
5142,F,test-clean,0,63040,63040,test-clean/5142/33396/5142-33396-0018.flac
5142,F,test-clean,0,63120,63120,test-clean/5142/33396/5142-33396-0035.flac
8455,M,test-clean,0,63120,63120,test-clean/8455/210777/8455-210777-0050.flac
4446,F,test-clean,0,63120,63120,test-clean/4446/2271/4446-2271-0011.flac
2830,M,test-clean,0,63120,63120,test-clean/2830/3980/2830-3980-0001.flac
61,M,test-clean,0,63200,63200,test-clean/61/70968/61-70968-0040.flac
7176,M,test-clean,0,63280,63280,test-clean/7176/92135/7176-92135-0003.flac
5142,F,test-clean,0,63360,63360,test-clean/5142/33396/5142-33396-0048.flac
7127,M,test-clean,0,63360,63360,test-clean/7127/75946/7127-75946-0025.flac
2830,M,test-clean,0,63360,63360,test-clean/2830/3980/2830-3980-0071.flac
61,M,test-clean,0,63440,63440,test-clean/61/70968/61-70968-0055.flac
1284,F,test-clean,0,63440,63440,test-clean/1284/1181/1284-1181-0000.flac
7021,M,test-clean,5632,69120,63488,test-clean/7021/79759/7021-79759-0000.flac
4970,F,test-clean,1024,64512,63488,test-clean/4970/29095/4970-29095-0006.flac
5683,F,test-clean,0,63520,63520,test-clean/5683/32866/5683-32866-0014.flac
1580,F,test-clean,0,63520,63520,test-clean/1580/141084/1580-141084-0014.flac
61,M,test-clean,0,63520,63520,test-clean/61/70970/61-70970-0022.flac
237,F,test-clean,0,63520,63520,test-clean/237/126133/237-126133-0009.flac
5105,M,test-clean,0,63680,63680,test-clean/5105/28241/5105-28241-0003.flac
1320,M,test-clean,0,63680,63680,test-clean/1320/122617/1320-122617-0030.flac
672,M,test-clean,0,63680,63680,test-clean/672/122797/672-122797-0031.flac
1580,F,test-clean,0,63680,63680,test-clean/1580/141083/1580-141083-0036.flac
8463,F,test-clean,0,63680,63680,test-clean/8463/294825/8463-294825-0008.flac
4507,F,test-clean,0,63840,63840,test-clean/4507/16021/4507-16021-0043.flac
1089,M,test-clean,0,63840,63840,test-clean/1089/134691/1089-134691-0020.flac
237,F,test-clean,0,63920,63920,test-clean/237/134500/237-134500-0010.flac
7127,M,test-clean,0,63920,63920,test-clean/7127/75947/7127-75947-0021.flac
672,M,test-clean,0,64000,64000,test-clean/672/122797/672-122797-0032.flac
3575,F,test-clean,0,64000,64000,test-clean/3575/170457/3575-170457-0031.flac
1580,F,test-clean,0,64160,64160,test-clean/1580/141084/1580-141084-0021.flac
1089,M,test-clean,0,64160,64160,test-clean/1089/134686/1089-134686-0026.flac
5105,M,test-clean,0,64160,64160,test-clean/5105/28240/5105-28240-0002.flac
1580,F,test-clean,0,64240,64240,test-clean/1580/141083/1580-141083-0053.flac
6829,F,test-clean,0,64240,64240,test-clean/6829/68771/6829-68771-0003.flac
4446,F,test-clean,0,64240,64240,test-clean/4446/2273/4446-2273-0009.flac
672,M,test-clean,0,64320,64320,test-clean/672/122797/672-122797-0068.flac
6829,F,test-clean,0,64320,64320,test-clean/6829/68769/6829-68769-0033.flac
672,M,test-clean,0,64400,64400,test-clean/672/122797/672-122797-0039.flac
61,M,test-clean,0,64480,64480,test-clean/61/70970/61-70970-0029.flac
237,F,test-clean,0,64480,64480,test-clean/237/134500/237-134500-0040.flac
121,F,test-clean,8192,72704,64512,test-clean/121/121726/121-121726-0008.flac
1284,F,test-clean,0,64640,64640,test-clean/1284/1181/1284-1181-0007.flac
7127,M,test-clean,0,64640,64640,test-clean/7127/75947/7127-75947-0018.flac
6829,F,test-clean,0,64720,64720,test-clean/6829/68769/6829-68769-0039.flac
7176,M,test-clean,0,64720,64720,test-clean/7176/88083/7176-88083-0009.flac
4992,F,test-clean,0,64720,64720,test-clean/4992/23283/4992-23283-0007.flac
2094,F,test-clean,0,64720,64720,test-clean/2094/142345/2094-142345-0050.flac
6930,M,test-clean,0,64800,64800,test-clean/6930/76324/6930-76324-0024.flac
908,M,test-clean,0,64960,64960,test-clean/908/157963/908-157963-0009.flac
672,M,test-clean,0,65120,65120,test-clean/672/122797/672-122797-0000.flac
4446,F,test-clean,0,65200,65200,test-clean/4446/2275/4446-2275-0035.flac
7729,M,test-clean,0,65200,65200,test-clean/7729/102255/7729-102255-0012.flac
1089,M,test-clean,0,65440,65440,test-clean/1089/134686/1089-134686-0032.flac
237,F,test-clean,0,65440,65440,test-clean/237/134493/237-134493-0013.flac
8555,F,test-clean,0,65440,65440,test-clean/8555/284447/8555-284447-0020.flac
5683,F,test-clean,0,65440,65440,test-clean/5683/32879/5683-32879-0021.flac
237,F,test-clean,0,65520,65520,test-clean/237/126133/237-126133-0018.flac
1580,F,test-clean,0,65600,65600,test-clean/1580/141084/1580-141084-0003.flac
7176,M,test-clean,0,65600,65600,test-clean/7176/92135/7176-92135-0024.flac
237,F,test-clean,0,65680,65680,test-clean/237/134493/237-134493-0000.flac
8455,M,test-clean,0,65760,65760,test-clean/8455/210777/8455-210777-0049.flac
672,M,test-clean,0,65760,65760,test-clean/672/122797/672-122797-0019.flac
6829,F,test-clean,0,65840,65840,test-clean/6829/68769/6829-68769-0022.flac
2300,M,test-clean,0,65920,65920,test-clean/2300/131720/2300-131720-0006.flac
6829,F,test-clean,0,65920,65920,test-clean/6829/68769/6829-68769-0016.flac
8455,M,test-clean,0,65920,65920,test-clean/8455/210777/8455-210777-0014.flac
5683,F,test-clean,0,65920,65920,test-clean/5683/32866/5683-32866-0007.flac
6930,M,test-clean,0,65920,65920,test-clean/6930/76324/6930-76324-0025.flac
4446,F,test-clean,0,66000,66000,test-clean/4446/2273/4446-2273-0005.flac
1995,F,test-clean,5120,71168,66048,test-clean/1995/1826/1995-1826-0002.flac
4446,F,test-clean,0,66080,66080,test-clean/4446/2275/4446-2275-0008.flac
672,M,test-clean,0,66080,66080,test-clean/672/122797/672-122797-0024.flac
1580,F,test-clean,0,66160,66160,test-clean/1580/141083/1580-141083-0032.flac
2830,M,test-clean,0,66320,66320,test-clean/2830/3980/2830-3980-0013.flac
5683,F,test-clean,0,66320,66320,test-clean/5683/32865/5683-32865-0015.flac
672,M,test-clean,0,66400,66400,test-clean/672/122797/672-122797-0021.flac
1320,M,test-clean,0,66400,66400,test-clean/1320/122617/1320-122617-0041.flac
7127,M,test-clean,0,66480,66480,test-clean/7127/75947/7127-75947-0008.flac
260,M,test-clean,4096,70656,66560,test-clean/260/123286/260-123286-0029.flac
3570,F,test-clean,0,66560,66560,test-clean/3570/5696/3570-5696-0006.flac
61,M,test-clean,0,66640,66640,test-clean/61/70970/61-70970-0002.flac
61,M,test-clean,0,66640,66640,test-clean/61/70970/61-70970-0040.flac
8463,F,test-clean,0,66720,66720,test-clean/8463/294828/8463-294828-0009.flac
5105,M,test-clean,0,66720,66720,test-clean/5105/28240/5105-28240-0016.flac
5683,F,test-clean,0,66800,66800,test-clean/5683/32879/5683-32879-0022.flac
3575,F,test-clean,0,66880,66880,test-clean/3575/170457/3575-170457-0021.flac
5142,F,test-clean,0,66880,66880,test-clean/5142/33396/5142-33396-0038.flac
1320,M,test-clean,0,66960,66960,test-clean/1320/122617/1320-122617-0008.flac
8555,F,test-clean,0,66960,66960,test-clean/8555/292519/8555-292519-0013.flac
3729,F,test-clean,0,67120,67120,test-clean/3729/6852/3729-6852-0016.flac
3729,F,test-clean,0,67280,67280,test-clean/3729/6852/3729-6852-0043.flac
4507,F,test-clean,0,67360,67360,test-clean/4507/16021/4507-16021-0005.flac
5683,F,test-clean,0,67440,67440,test-clean/5683/32866/5683-32866-0006.flac
6829,F,test-clean,0,67440,67440,test-clean/6829/68769/6829-68769-0003.flac
61,M,test-clean,0,67520,67520,test-clean/61/70968/61-70968-0053.flac
6829,F,test-clean,0,67520,67520,test-clean/6829/68769/6829-68769-0009.flac
260,M,test-clean,4096,71680,67584,test-clean/260/123286/260-123286-0013.flac
237,F,test-clean,0,67600,67600,test-clean/237/134500/237-134500-0006.flac
4992,F,test-clean,0,67600,67600,test-clean/4992/23283/4992-23283-0011.flac
61,M,test-clean,0,67680,67680,test-clean/61/70968/61-70968-0034.flac
5142,F,test-clean,0,67760,67760,test-clean/5142/33396/5142-33396-0068.flac
237,F,test-clean,0,68000,68000,test-clean/237/134500/237-134500-0014.flac
237,F,test-clean,0,68000,68000,test-clean/237/126133/237-126133-0016.flac
672,M,test-clean,0,68000,68000,test-clean/672/122797/672-122797-0054.flac
1188,M,test-clean,0,68000,68000,test-clean/1188/133604/1188-133604-0031.flac
1580,F,test-clean,0,68080,68080,test-clean/1580/141083/1580-141083-0016.flac
908,M,test-clean,0,68080,68080,test-clean/908/157963/908-157963-0018.flac
4970,F,test-clean,0,68096,68096,test-clean/4970/29095/4970-29095-0012.flac
260,M,test-clean,8704,76800,68096,test-clean/260/123288/260-123288-0006.flac
121,F,test-clean,2048,70144,68096,test-clean/121/127105/121-127105-0006.flac
5142,F,test-clean,0,68160,68160,test-clean/5142/33396/5142-33396-0036.flac
1284,F,test-clean,0,68400,68400,test-clean/1284/1180/1284-1180-0011.flac
1089,M,test-clean,0,68400,68400,test-clean/1089/134686/1089-134686-0007.flac
61,M,test-clean,0,68480,68480,test-clean/61/70968/61-70968-0032.flac
7021,M,test-clean,0,68480,68480,test-clean/7021/85628/7021-85628-0016.flac
672,M,test-clean,0,68560,68560,test-clean/672/122797/672-122797-0052.flac
1284,F,test-clean,0,68560,68560,test-clean/1284/1180/1284-1180-0004.flac
5142,F,test-clean,0,68719,68719,test-clean/5142/36377/5142-36377-0010.flac
6829,F,test-clean,0,68720,68720,test-clean/6829/68769/6829-68769-0012.flac
7176,M,test-clean,0,68720,68720,test-clean/7176/88083/7176-88083-0006.flac
3570,F,test-clean,0,68720,68720,test-clean/3570/5694/3570-5694-0022.flac
6930,M,test-clean,0,68880,68880,test-clean/6930/76324/6930-76324-0013.flac
1580,F,test-clean,0,68880,68880,test-clean/1580/141083/1580-141083-0008.flac
5142,F,test-clean,0,68960,68960,test-clean/5142/33396/5142-33396-0015.flac
4507,F,test-clean,0,69040,69040,test-clean/4507/16021/4507-16021-0054.flac
61,M,test-clean,0,69040,69040,test-clean/61/70968/61-70968-0003.flac
61,M,test-clean,0,69040,69040,test-clean/61/70968/61-70968-0037.flac
2830,M,test-clean,0,69040,69040,test-clean/2830/3979/2830-3979-0002.flac
4077,M,test-clean,0,69040,69040,test-clean/4077/13751/4077-13751-0013.flac
908,M,test-clean,0,69040,69040,test-clean/908/157963/908-157963-0013.flac
1580,F,test-clean,0,69120,69120,test-clean/1580/141083/1580-141083-0013.flac
8463,F,test-clean,0,69200,69200,test-clean/8463/287645/8463-287645-0010.flac
6930,M,test-clean,0,69440,69440,test-clean/6930/81414/6930-81414-0022.flac
5142,F,test-clean,0,69440,69440,test-clean/5142/36377/5142-36377-0015.flac
61,M,test-clean,0,69600,69600,test-clean/61/70970/61-70970-0013.flac
4992,F,test-clean,0,69680,69680,test-clean/4992/41806/4992-41806-0009.flac
1580,F,test-clean,0,69760,69760,test-clean/1580/141083/1580-141083-0045.flac
237,F,test-clean,0,69840,69840,test-clean/237/126133/237-126133-0021.flac
6930,M,test-clean,0,69840,69840,test-clean/6930/81414/6930-81414-0007.flac
61,M,test-clean,0,69920,69920,test-clean/61/70970/61-70970-0016.flac
7176,M,test-clean,0,70080,70080,test-clean/7176/92135/7176-92135-0009.flac
5683,F,test-clean,0,70080,70080,test-clean/5683/32879/5683-32879-0012.flac
7021,M,test-clean,5632,75776,70144,test-clean/7021/79740/7021-79740-0003.flac
6829,F,test-clean,0,70240,70240,test-clean/6829/68771/6829-68771-0035.flac
1188,M,test-clean,0,70240,70240,test-clean/1188/133604/1188-133604-0014.flac
8463,F,test-clean,0,70320,70320,test-clean/8463/294828/8463-294828-0032.flac
237,F,test-clean,0,70320,70320,test-clean/237/134493/237-134493-0006.flac
3729,F,test-clean,0,70400,70400,test-clean/3729/6852/3729-6852-0031.flac
4446,F,test-clean,0,70400,70400,test-clean/4446/2271/4446-2271-0013.flac
1320,M,test-clean,0,70400,70400,test-clean/1320/122617/1320-122617-0005.flac
1089,M,test-clean,0,70480,70480,test-clean/1089/134686/1089-134686-0010.flac
61,M,test-clean,0,70560,70560,test-clean/61/70968/61-70968-0025.flac
237,F,test-clean,0,70560,70560,test-clean/237/134500/237-134500-0024.flac
7127,M,test-clean,0,70640,70640,test-clean/7127/75947/7127-75947-0035.flac
8555,F,test-clean,0,70640,70640,test-clean/8555/284447/8555-284447-0003.flac
4970,F,test-clean,0,70656,70656,test-clean/4970/29095/4970-29095-0030.flac
6930,M,test-clean,0,70880,70880,test-clean/6930/81414/6930-81414-0012.flac
7176,M,test-clean,0,70880,70880,test-clean/7176/92135/7176-92135-0008.flac
4446,F,test-clean,0,71120,71120,test-clean/4446/2275/4446-2275-0005.flac
260,M,test-clean,0,71168,71168,test-clean/260/123286/260-123286-0007.flac
61,M,test-clean,0,71200,71200,test-clean/61/70968/61-70968-0013.flac
237,F,test-clean,0,71200,71200,test-clean/237/126133/237-126133-0012.flac
672,M,test-clean,0,71280,71280,test-clean/672/122797/672-122797-0015.flac
6930,M,test-clean,0,71280,71280,test-clean/6930/76324/6930-76324-0006.flac
7127,M,test-clean,0,71360,71360,test-clean/7127/75946/7127-75946-0008.flac
7176,M,test-clean,0,71440,71440,test-clean/7176/92135/7176-92135-0034.flac
1580,F,test-clean,0,71520,71520,test-clean/1580/141084/1580-141084-0010.flac
672,M,test-clean,0,71520,71520,test-clean/672/122797/672-122797-0058.flac
8463,F,test-clean,0,71600,71600,test-clean/8463/294825/8463-294825-0016.flac
1995,F,test-clean,4096,75776,71680,test-clean/1995/1826/1995-1826-0005.flac
1580,F,test-clean,0,71680,71680,test-clean/1580/141083/1580-141083-0024.flac
61,M,test-clean,0,71760,71760,test-clean/61/70970/61-70970-0007.flac
61,M,test-clean,0,71760,71760,test-clean/61/70970/61-70970-0034.flac
1995,F,test-clean,0,71760,71760,test-clean/1995/1837/1995-1837-0015.flac
5105,M,test-clean,0,71840,71840,test-clean/5105/28233/5105-28233-0001.flac
1580,F,test-clean,0,71840,71840,test-clean/1580/141084/1580-141084-0034.flac
908,M,test-clean,0,71840,71840,test-clean/908/31957/908-31957-0005.flac
7127,M,test-clean,0,71840,71840,test-clean/7127/75946/7127-75946-0004.flac
4992,F,test-clean,0,71920,71920,test-clean/4992/23283/4992-23283-0016.flac
4446,F,test-clean,0,72080,72080,test-clean/4446/2273/4446-2273-0015.flac
1284,F,test-clean,0,72080,72080,test-clean/1284/1181/1284-1181-0003.flac
5105,M,test-clean,0,72160,72160,test-clean/5105/28233/5105-28233-0000.flac
61,M,test-clean,0,72160,72160,test-clean/61/70968/61-70968-0009.flac
3570,F,test-clean,2048,74240,72192,test-clean/3570/5695/3570-5695-0013.flac
5142,F,test-clean,2048,74240,72192,test-clean/5142/36377/5142-36377-0017.flac
260,M,test-clean,8192,80384,72192,test-clean/260/123288/260-123288-0001.flac
1580,F,test-clean,0,72240,72240,test-clean/1580/141083/1580-141083-0004.flac
260,M,test-clean,8704,80960,72256,test-clean/260/123286/260-123286-0031.flac
908,M,test-clean,0,72320,72320,test-clean/908/157963/908-157963-0030.flac
908,M,test-clean,0,72320,72320,test-clean/908/157963/908-157963-0014.flac
8455,M,test-clean,0,72320,72320,test-clean/8455/210777/8455-210777-0006.flac
237,F,test-clean,0,72399,72399,test-clean/237/134500/237-134500-0028.flac
6829,F,test-clean,0,72400,72400,test-clean/6829/68771/6829-68771-0015.flac
4446,F,test-clean,0,72480,72480,test-clean/4446/2275/4446-2275-0038.flac
8463,F,test-clean,0,72480,72480,test-clean/8463/294828/8463-294828-0019.flac
5142,F,test-clean,0,72480,72480,test-clean/5142/36377/5142-36377-0020.flac
4992,F,test-clean,0,72560,72560,test-clean/4992/23283/4992-23283-0014.flac
4992,F,test-clean,0,72800,72800,test-clean/4992/41797/4992-41797-0006.flac
2830,M,test-clean,0,72800,72800,test-clean/2830/3979/2830-3979-0006.flac
1580,F,test-clean,0,73040,73040,test-clean/1580/141083/1580-141083-0007.flac
672,M,test-clean,0,73200,73200,test-clean/672/122797/672-122797-0030.flac
3575,F,test-clean,0,73280,73280,test-clean/3575/170457/3575-170457-0027.flac
8455,M,test-clean,0,73280,73280,test-clean/8455/210777/8455-210777-0009.flac
8463,F,test-clean,0,73281,73281,test-clean/8463/294825/8463-294825-0010.flac
5683,F,test-clean,0,73360,73360,test-clean/5683/32866/5683-32866-0017.flac
5683,F,test-clean,0,73440,73440,test-clean/5683/32866/5683-32866-0005.flac
4507,F,test-clean,0,73440,73440,test-clean/4507/16021/4507-16021-0046.flac
5142,F,test-clean,0,73440,73440,test-clean/5142/33396/5142-33396-0012.flac
8230,M,test-clean,0,73440,73440,test-clean/8230/279154/8230-279154-0039.flac
6829,F,test-clean,0,73600,73600,test-clean/6829/68769/6829-68769-0052.flac
61,M,test-clean,0,73600,73600,test-clean/61/70970/61-70970-0018.flac
2961,F,test-clean,0,73600,73600,test-clean/2961/961/2961-961-0006.flac
1995,F,test-clean,1536,75264,73728,test-clean/1995/1836/1995-1836-0011.flac
2300,M,test-clean,1536,75264,73728,test-clean/2300/131720/2300-131720-0024.flac
908,M,test-clean,0,73760,73760,test-clean/908/157963/908-157963-0022.flac
4507,F,test-clean,0,73760,73760,test-clean/4507/16021/4507-16021-0057.flac
6829,F,test-clean,0,73840,73840,test-clean/6829/68771/6829-68771-0020.flac
1188,M,test-clean,0,73840,73840,test-clean/1188/133604/1188-133604-0017.flac
1580,F,test-clean,0,73840,73840,test-clean/1580/141084/1580-141084-0000.flac
5105,M,test-clean,0,74000,74000,test-clean/5105/28240/5105-28240-0007.flac
237,F,test-clean,0,74080,74080,test-clean/237/134500/237-134500-0039.flac
5142,F,test-clean,0,74160,74160,test-clean/5142/36377/5142-36377-0006.flac
8555,F,test-clean,0,74160,74160,test-clean/8555/284447/8555-284447-0024.flac
1995,F,test-clean,4096,78336,74240,test-clean/1995/1826/1995-1826-0018.flac
1995,F,test-clean,1536,75776,74240,test-clean/1995/1826/1995-1826-0022.flac
6829,F,test-clean,0,74240,74240,test-clean/6829/68769/6829-68769-0026.flac
4992,F,test-clean,0,74320,74320,test-clean/4992/23283/4992-23283-0003.flac
4970,F,test-clean,0,74400,74400,test-clean/4970/29095/4970-29095-0005.flac
6930,M,test-clean,0,74480,74480,test-clean/6930/76324/6930-76324-0012.flac
4446,F,test-clean,0,74560,74560,test-clean/4446/2273/4446-2273-0001.flac
4446,F,test-clean,0,74560,74560,test-clean/4446/2275/4446-2275-0001.flac
2961,F,test-clean,0,74640,74640,test-clean/2961/961/2961-961-0000.flac
3570,F,test-clean,0,74640,74640,test-clean/3570/5695/3570-5695-0010.flac
672,M,test-clean,0,74640,74640,test-clean/672/122797/672-122797-0051.flac
1089,M,test-clean,0,74720,74720,test-clean/1089/134686/1089-134686-0029.flac
61,M,test-clean,0,74720,74720,test-clean/61/70968/61-70968-0022.flac
7176,M,test-clean,0,74720,74720,test-clean/7176/88083/7176-88083-0014.flac
1580,F,test-clean,0,74960,74960,test-clean/1580/141084/1580-141084-0009.flac
6829,F,test-clean,0,74960,74960,test-clean/6829/68769/6829-68769-0011.flac
3729,F,test-clean,0,75040,75040,test-clean/3729/6852/3729-6852-0026.flac
6930,M,test-clean,0,75200,75200,test-clean/6930/81414/6930-81414-0011.flac
7176,M,test-clean,0,75200,75200,test-clean/7176/88083/7176-88083-0005.flac
3570,F,test-clean,0,75200,75200,test-clean/3570/5696/3570-5696-0004.flac
4970,F,test-clean,8704,83968,75264,test-clean/4970/29093/4970-29093-0020.flac
260,M,test-clean,0,75264,75264,test-clean/260/123286/260-123286-0005.flac
672,M,test-clean,0,75440,75440,test-clean/672/122797/672-122797-0046.flac
6930,M,test-clean,0,75520,75520,test-clean/6930/76324/6930-76324-0014.flac
7127,M,test-clean,0,75520,75520,test-clean/7127/75946/7127-75946-0009.flac
5105,M,test-clean,0,75600,75600,test-clean/5105/28240/5105-28240-0022.flac
2961,F,test-clean,0,75680,75680,test-clean/2961/961/2961-961-0003.flac
5105,M,test-clean,0,75680,75680,test-clean/5105/28240/5105-28240-0012.flac
8455,M,test-clean,0,75680,75680,test-clean/8455/210777/8455-210777-0023.flac
8463,F,test-clean,0,75680,75680,test-clean/8463/287645/8463-287645-0000.flac
5105,M,test-clean,0,75760,75760,test-clean/5105/28233/5105-28233-0004.flac
8455,M,test-clean,0,75760,75760,test-clean/8455/210777/8455-210777-0037.flac
260,M,test-clean,4608,80384,75776,test-clean/260/123286/260-123286-0015.flac
121,F,test-clean,2560,78336,75776,test-clean/121/127105/121-127105-0022.flac
6829,F,test-clean,0,75840,75840,test-clean/6829/68769/6829-68769-0008.flac
7127,M,test-clean,0,75920,75920,test-clean/7127/75947/7127-75947-0032.flac
8463,F,test-clean,0,75920,75920,test-clean/8463/294828/8463-294828-0023.flac
4970,F,test-clean,0,76000,76000,test-clean/4970/29095/4970-29095-0035.flac
1221,F,test-clean,0,76000,76000,test-clean/1221/135766/1221-135766-0014.flac
1089,M,test-clean,0,76080,76080,test-clean/1089/134691/1089-134691-0014.flac
4992,F,test-clean,0,76080,76080,test-clean/4992/41797/4992-41797-0019.flac
7127,M,test-clean,0,76080,76080,test-clean/7127/75946/7127-75946-0007.flac
5683,F,test-clean,0,76080,76080,test-clean/5683/32866/5683-32866-0027.flac
4446,F,test-clean,0,76080,76080,test-clean/4446/2275/4446-2275-0041.flac
672,M,test-clean,0,76160,76160,test-clean/672/122797/672-122797-0003.flac
4970,F,test-clean,0,76240,76240,test-clean/4970/29095/4970-29095-0022.flac
260,M,test-clean,0,76288,76288,test-clean/260/123288/260-123288-0016.flac
6829,F,test-clean,0,76320,76320,test-clean/6829/68769/6829-68769-0040.flac
6829,F,test-clean,0,76320,76320,test-clean/6829/68771/6829-68771-0014.flac
5142,F,test-clean,0,76320,76320,test-clean/5142/33396/5142-33396-0022.flac
1580,F,test-clean,0,76400,76400,test-clean/1580/141083/1580-141083-0026.flac
61,M,test-clean,0,76400,76400,test-clean/61/70968/61-70968-0047.flac
4077,M,test-clean,0,76480,76480,test-clean/4077/13754/4077-13754-0000.flac
8455,M,test-clean,0,76480,76480,test-clean/8455/210777/8455-210777-0042.flac
6930,M,test-clean,0,76560,76560,test-clean/6930/75918/6930-75918-0008.flac
672,M,test-clean,0,76640,76640,test-clean/672/122797/672-122797-0027.flac
237,F,test-clean,0,76640,76640,test-clean/237/134493/237-134493-0018.flac
908,M,test-clean,0,76640,76640,test-clean/908/31957/908-31957-0002.flac
3575,F,test-clean,0,76640,76640,test-clean/3575/170457/3575-170457-0010.flac
4970,F,test-clean,6144,82944,76800,test-clean/4970/29095/4970-29095-0009.flac
8224,M,test-clean,0,76880,76880,test-clean/8224/274384/8224-274384-0009.flac
7127,M,test-clean,0,76960,76960,test-clean/7127/75946/7127-75946-0003.flac
2830,M,test-clean,0,76960,76960,test-clean/2830/3980/2830-3980-0076.flac
672,M,test-clean,0,77040,77040,test-clean/672/122797/672-122797-0066.flac
5105,M,test-clean,0,77120,77120,test-clean/5105/28241/5105-28241-0013.flac
672,M,test-clean,0,77120,77120,test-clean/672/122797/672-122797-0017.flac
1284,F,test-clean,0,77200,77200,test-clean/1284/1180/1284-1180-0031.flac
1221,F,test-clean,0,77200,77200,test-clean/1221/135766/1221-135766-0002.flac
4446,F,test-clean,0,77200,77200,test-clean/4446/2273/4446-2273-0024.flac
4446,F,test-clean,0,77280,77280,test-clean/4446/2273/4446-2273-0025.flac
121,F,test-clean,0,77280,77280,test-clean/121/127105/121-127105-0012.flac
3570,F,test-clean,0,77280,77280,test-clean/3570/5695/3570-5695-0000.flac
260,M,test-clean,0,77312,77312,test-clean/260/123440/260-123440-0011.flac
2300,M,test-clean,0,77312,77312,test-clean/2300/131720/2300-131720-0000.flac
1284,F,test-clean,0,77360,77360,test-clean/1284/1180/1284-1180-0003.flac
2830,M,test-clean,0,77440,77440,test-clean/2830/3980/2830-3980-0008.flac
5683,F,test-clean,0,77520,77520,test-clean/5683/32866/5683-32866-0030.flac
1320,M,test-clean,0,77520,77520,test-clean/1320/122612/1320-122612-0006.flac
6930,M,test-clean,0,77600,77600,test-clean/6930/76324/6930-76324-0023.flac
2830,M,test-clean,0,77680,77680,test-clean/2830/3980/2830-3980-0072.flac
5142,F,test-clean,0,77680,77680,test-clean/5142/33396/5142-33396-0044.flac
672,M,test-clean,0,77680,77680,test-clean/672/122797/672-122797-0050.flac
7021,M,test-clean,3584,81408,77824,test-clean/7021/85628/7021-85628-0012.flac
2830,M,test-clean,0,78080,78080,test-clean/2830/3980/2830-3980-0052.flac
8463,F,test-clean,0,78080,78080,test-clean/8463/294828/8463-294828-0015.flac
1284,F,test-clean,0,78080,78080,test-clean/1284/1180/1284-1180-0012.flac
5683,F,test-clean,0,78080,78080,test-clean/5683/32866/5683-32866-0016.flac
1188,M,test-clean,0,78160,78160,test-clean/1188/133604/1188-133604-0043.flac
6930,M,test-clean,0,78160,78160,test-clean/6930/81414/6930-81414-0023.flac
1580,F,test-clean,0,78160,78160,test-clean/1580/141084/1580-141084-0039.flac
2830,M,test-clean,0,78240,78240,test-clean/2830/3980/2830-3980-0041.flac
4507,F,test-clean,0,78240,78240,test-clean/4507/16021/4507-16021-0045.flac
6829,F,test-clean,0,78240,78240,test-clean/6829/68769/6829-68769-0023.flac
4507,F,test-clean,0,78320,78320,test-clean/4507/16021/4507-16021-0003.flac
260,M,test-clean,0,78320,78320,test-clean/260/123440/260-123440-0016.flac
121,F,test-clean,1024,79360,78336,test-clean/121/127105/121-127105-0001.flac
4970,F,test-clean,2048,80384,78336,test-clean/4970/29095/4970-29095-0036.flac
1320,M,test-clean,0,78400,78400,test-clean/1320/122617/1320-122617-0014.flac
61,M,test-clean,0,78480,78480,test-clean/61/70968/61-70968-0000.flac
8463,F,test-clean,0,78480,78480,test-clean/8463/294828/8463-294828-0012.flac
4992,F,test-clean,0,78560,78560,test-clean/4992/23283/4992-23283-0008.flac
6829,F,test-clean,0,78560,78560,test-clean/6829/68769/6829-68769-0030.flac
6829,F,test-clean,8192,86800,78608,test-clean/6829/68771/6829-68771-0023.flac
3575,F,test-clean,0,78640,78640,test-clean/3575/170457/3575-170457-0051.flac
61,M,test-clean,0,78720,78720,test-clean/61/70968/61-70968-0026.flac
7021,M,test-clean,2560,81408,78848,test-clean/7021/85628/7021-85628-0022.flac
2094,F,test-clean,0,78880,78880,test-clean/2094/142345/2094-142345-0058.flac
4446,F,test-clean,0,78880,78880,test-clean/4446/2275/4446-2275-0019.flac
672,M,test-clean,0,78880,78880,test-clean/672/122797/672-122797-0018.flac
7176,M,test-clean,0,79040,79040,test-clean/7176/92135/7176-92135-0041.flac
2961,F,test-clean,0,79040,79040,test-clean/2961/961/2961-961-0021.flac
8455,M,test-clean,0,79040,79040,test-clean/8455/210777/8455-210777-0052.flac
6829,F,test-clean,0,79120,79120,test-clean/6829/68769/6829-68769-0024.flac
908,M,test-clean,0,79200,79200,test-clean/908/157963/908-157963-0017.flac
908,M,test-clean,0,79280,79280,test-clean/908/157963/908-157963-0028.flac
5142,F,test-clean,0,79520,79520,test-clean/5142/36377/5142-36377-0018.flac
5142,F,test-clean,0,79600,79600,test-clean/5142/33396/5142-33396-0007.flac
5683,F,test-clean,0,79600,79600,test-clean/5683/32879/5683-32879-0023.flac
1580,F,test-clean,0,79680,79680,test-clean/1580/141083/1580-141083-0035.flac
5142,F,test-clean,0,79760,79760,test-clean/5142/33396/5142-33396-0019.flac
1580,F,test-clean,0,79760,79760,test-clean/1580/141083/1580-141083-0015.flac
4077,M,test-clean,0,79760,79760,test-clean/4077/13754/4077-13754-0004.flac
260,M,test-clean,4096,83920,79824,test-clean/260/123440/260-123440-0012.flac
8455,M,test-clean,0,79840,79840,test-clean/8455/210777/8455-210777-0035.flac
1995,F,test-clean,0,79872,79872,test-clean/1995/1826/1995-1826-0024.flac
260,M,test-clean,0,79920,79920,test-clean/260/123440/260-123440-0020.flac
1580,F,test-clean,0,79920,79920,test-clean/1580/141084/1580-141084-0032.flac
6930,M,test-clean,0,80000,80000,test-clean/6930/81414/6930-81414-0020.flac
1580,F,test-clean,0,80000,80000,test-clean/1580/141084/1580-141084-0011.flac
4992,F,test-clean,0,80000,80000,test-clean/4992/23283/4992-23283-0010.flac
2830,M,test-clean,0,80000,80000,test-clean/2830/3980/2830-3980-0068.flac
672,M,test-clean,0,80160,80160,test-clean/672/122797/672-122797-0069.flac
7021,M,test-clean,0,80240,80240,test-clean/7021/85628/7021-85628-0005.flac
2830,M,test-clean,0,80240,80240,test-clean/2830/3980/2830-3980-0053.flac
5142,F,test-clean,0,80320,80320,test-clean/5142/33396/5142-33396-0001.flac
61,M,test-clean,0,80400,80400,test-clean/61/70970/61-70970-0020.flac
6930,M,test-clean,0,80400,80400,test-clean/6930/75918/6930-75918-0002.flac
237,F,test-clean,0,80400,80400,test-clean/237/134500/237-134500-0032.flac
61,M,test-clean,0,80400,80400,test-clean/61/70968/61-70968-0023.flac
3570,F,test-clean,0,80400,80400,test-clean/3570/5695/3570-5695-0009.flac
1995,F,test-clean,3584,84000,80416,test-clean/1995/1826/1995-1826-0019.flac
6930,M,test-clean,0,80560,80560,test-clean/6930/76324/6930-76324-0005.flac
237,F,test-clean,0,80560,80560,test-clean/237/134493/237-134493-0011.flac
237,F,test-clean,0,80640,80640,test-clean/237/126133/237-126133-0022.flac
5142,F,test-clean,1536,82240,80704,test-clean/5142/36377/5142-36377-0009.flac
7176,M,test-clean,0,80720,80720,test-clean/7176/88083/7176-88083-0012.flac
7127,M,test-clean,0,80720,80720,test-clean/7127/75947/7127-75947-0013.flac
6930,M,test-clean,0,80800,80800,test-clean/6930/81414/6930-81414-0024.flac
4446,F,test-clean,0,80800,80800,test-clean/4446/2275/4446-2275-0021.flac
5142,F,test-clean,0,80880,80880,test-clean/5142/36586/5142-36586-0003.flac
260,M,test-clean,0,80896,80896,test-clean/260/123288/260-123288-0017.flac
4970,F,test-clean,0,80896,80896,test-clean/4970/29095/4970-29095-0002.flac
1995,F,test-clean,4096,84992,80896,test-clean/1995/1837/1995-1837-0024.flac
1580,F,test-clean,0,80960,80960,test-clean/1580/141084/1580-141084-0042.flac
6829,F,test-clean,1024,82000,80976,test-clean/6829/68769/6829-68769-0020.flac
61,M,test-clean,0,81040,81040,test-clean/61/70968/61-70968-0057.flac
61,M,test-clean,0,81120,81120,test-clean/61/70968/61-70968-0005.flac
237,F,test-clean,0,81120,81120,test-clean/237/134500/237-134500-0002.flac
672,M,test-clean,0,81200,81200,test-clean/672/122797/672-122797-0063.flac
61,M,test-clean,512,81760,81248,test-clean/61/70968/61-70968-0017.flac
61,M,test-clean,0,81280,81280,test-clean/61/70970/61-70970-0027.flac
7021,M,test-clean,2560,84000,81440,test-clean/7021/79759/7021-79759-0002.flac
7127,M,test-clean,0,81440,81440,test-clean/7127/75946/7127-75946-0024.flac
4077,M,test-clean,0,81520,81520,test-clean/4077/13751/4077-13751-0017.flac
8555,F,test-clean,0,81520,81520,test-clean/8555/284449/8555-284449-0020.flac
61,M,test-clean,0,81680,81680,test-clean/61/70968/61-70968-0020.flac
908,M,test-clean,0,81680,81680,test-clean/908/157963/908-157963-0016.flac
672,M,test-clean,0,81760,81760,test-clean/672/122797/672-122797-0034.flac
7127,M,test-clean,0,81760,81760,test-clean/7127/75947/7127-75947-0023.flac
1284,F,test-clean,0,81840,81840,test-clean/1284/1181/1284-1181-0015.flac
2961,F,test-clean,0,81920,81920,test-clean/2961/961/2961-961-0013.flac
237,F,test-clean,0,81920,81920,test-clean/237/134500/237-134500-0021.flac
2300,M,test-clean,2048,83968,81920,test-clean/2300/131720/2300-131720-0038.flac
8555,F,test-clean,0,81920,81920,test-clean/8555/292519/8555-292519-0012.flac
8555,F,test-clean,0,81920,81920,test-clean/8555/284449/8555-284449-0015.flac
672,M,test-clean,0,82000,82000,test-clean/672/122797/672-122797-0040.flac
1320,M,test-clean,0,82000,82000,test-clean/1320/122617/1320-122617-0015.flac
5683,F,test-clean,0,82000,82000,test-clean/5683/32866/5683-32866-0002.flac
1580,F,test-clean,0,82160,82160,test-clean/1580/141083/1580-141083-0020.flac
5683,F,test-clean,0,82160,82160,test-clean/5683/32879/5683-32879-0009.flac
61,M,test-clean,0,82160,82160,test-clean/61/70970/61-70970-0031.flac
6829,F,test-clean,6656,88880,82224,test-clean/6829/68769/6829-68769-0036.flac
4507,F,test-clean,0,82240,82240,test-clean/4507/16021/4507-16021-0024.flac
2300,M,test-clean,0,82432,82432,test-clean/2300/131720/2300-131720-0040.flac
237,F,test-clean,0,82640,82640,test-clean/237/134500/237-134500-0022.flac
7176,M,test-clean,0,82800,82800,test-clean/7176/92135/7176-92135-0044.flac
1089,M,test-clean,0,82801,82801,test-clean/1089/134691/1089-134691-0004.flac
7729,M,test-clean,0,82880,82880,test-clean/7729/102255/7729-102255-0005.flac
2094,F,test-clean,0,82880,82880,test-clean/2094/142345/2094-142345-0023.flac
6930,M,test-clean,0,82960,82960,test-clean/6930/76324/6930-76324-0008.flac
2830,M,test-clean,0,83120,83120,test-clean/2830/3980/2830-3980-0039.flac
5142,F,test-clean,0,83120,83120,test-clean/5142/33396/5142-33396-0065.flac
6829,F,test-clean,0,83200,83200,test-clean/6829/68771/6829-68771-0036.flac
1089,M,test-clean,0,83360,83360,test-clean/1089/134686/1089-134686-0037.flac
4507,F,test-clean,0,83440,83440,test-clean/4507/16021/4507-16021-0048.flac
1089,M,test-clean,0,83441,83441,test-clean/1089/134686/1089-134686-0004.flac
121,F,test-clean,8192,91648,83456,test-clean/121/121726/121-121726-0001.flac
908,M,test-clean,0,83600,83600,test-clean/908/157963/908-157963-0027.flac
672,M,test-clean,0,83600,83600,test-clean/672/122797/672-122797-0056.flac
1580,F,test-clean,0,83600,83600,test-clean/1580/141083/1580-141083-0027.flac
1320,M,test-clean,0,83600,83600,test-clean/1320/122617/1320-122617-0026.flac
7176,M,test-clean,0,83680,83680,test-clean/7176/92135/7176-92135-0045.flac
1995,F,test-clean,1024,84800,83776,test-clean/1995/1836/1995-1836-0013.flac
3729,F,test-clean,0,83840,83840,test-clean/3729/6852/3729-6852-0036.flac
1284,F,test-clean,0,83920,83920,test-clean/1284/1181/1284-1181-0009.flac
5639,M,test-clean,3584,87552,83968,test-clean/5639/40744/5639-40744-0005.flac
1580,F,test-clean,0,84000,84000,test-clean/1580/141084/1580-141084-0047.flac
2830,M,test-clean,0,84000,84000,test-clean/2830/3980/2830-3980-0030.flac
4446,F,test-clean,0,84080,84080,test-clean/4446/2273/4446-2273-0021.flac
1284,F,test-clean,0,84160,84160,test-clean/1284/1180/1284-1180-0024.flac
3729,F,test-clean,0,84240,84240,test-clean/3729/6852/3729-6852-0028.flac
2094,F,test-clean,0,84320,84320,test-clean/2094/142345/2094-142345-0024.flac
5142,F,test-clean,0,84480,84480,test-clean/5142/33396/5142-33396-0033.flac
8463,F,test-clean,0,84560,84560,test-clean/8463/294828/8463-294828-0029.flac
7127,M,test-clean,0,84560,84560,test-clean/7127/75947/7127-75947-0029.flac
5105,M,test-clean,0,84640,84640,test-clean/5105/28241/5105-28241-0019.flac
2961,F,test-clean,0,84640,84640,test-clean/2961/961/2961-961-0018.flac
7729,M,test-clean,0,84720,84720,test-clean/7729/102255/7729-102255-0014.flac
2094,F,test-clean,0,84960,84960,test-clean/2094/142345/2094-142345-0051.flac
5639,M,test-clean,4096,89088,84992,test-clean/5639/40744/5639-40744-0017.flac
6829,F,test-clean,0,85120,85120,test-clean/6829/68771/6829-68771-0027.flac
1580,F,test-clean,0,85120,85120,test-clean/1580/141083/1580-141083-0010.flac
3570,F,test-clean,0,85280,85280,test-clean/3570/5694/3570-5694-0004.flac
8455,M,test-clean,0,85281,85281,test-clean/8455/210777/8455-210777-0017.flac
1284,F,test-clean,0,85360,85360,test-clean/1284/1180/1284-1180-0029.flac
1320,M,test-clean,0,85360,85360,test-clean/1320/122617/1320-122617-0021.flac
2094,F,test-clean,0,85360,85360,test-clean/2094/142345/2094-142345-0021.flac
4446,F,test-clean,0,85440,85440,test-clean/4446/2271/4446-2271-0014.flac
5142,F,test-clean,0,85520,85520,test-clean/5142/33396/5142-33396-0024.flac
5639,M,test-clean,7680,93200,85520,test-clean/5639/40744/5639-40744-0007.flac
2830,M,test-clean,0,85600,85600,test-clean/2830/3980/2830-3980-0056.flac
4507,F,test-clean,0,85600,85600,test-clean/4507/16021/4507-16021-0037.flac
3570,F,test-clean,0,85680,85680,test-clean/3570/5695/3570-5695-0003.flac
61,M,test-clean,0,85680,85680,test-clean/61/70968/61-70968-0028.flac
1089,M,test-clean,0,85760,85760,test-clean/1089/134691/1089-134691-0005.flac
672,M,test-clean,0,85840,85840,test-clean/672/122797/672-122797-0036.flac
7021,M,test-clean,0,85840,85840,test-clean/7021/85628/7021-85628-0021.flac
1188,M,test-clean,0,85840,85840,test-clean/1188/133604/1188-133604-0038.flac
8463,F,test-clean,0,85920,85920,test-clean/8463/294828/8463-294828-0037.flac
61,M,test-clean,0,86000,86000,test-clean/61/70968/61-70968-0015.flac
260,M,test-clean,6144,92160,86016,test-clean/260/123286/260-123286-0009.flac
7021,M,test-clean,7680,93696,86016,test-clean/7021/79740/7021-79740-0001.flac
121,F,test-clean,2048,88064,86016,test-clean/121/127105/121-127105-0007.flac
1995,F,test-clean,0,86080,86080,test-clean/1995/1837/1995-1837-0019.flac
5142,F,test-clean,0,86240,86240,test-clean/5142/36377/5142-36377-0001.flac
4446,F,test-clean,0,86400,86400,test-clean/4446/2275/4446-2275-0042.flac
4446,F,test-clean,0,86480,86480,test-clean/4446/2273/4446-2273-0028.flac
61,M,test-clean,0,86480,86480,test-clean/61/70970/61-70970-0021.flac
121,F,test-clean,1024,87552,86528,test-clean/121/127105/121-127105-0013.flac
6930,M,test-clean,0,86560,86560,test-clean/6930/76324/6930-76324-0017.flac
2830,M,test-clean,0,86640,86640,test-clean/2830/3980/2830-3980-0063.flac
7176,M,test-clean,0,86640,86640,test-clean/7176/88083/7176-88083-0020.flac
1089,M,test-clean,0,86640,86640,test-clean/1089/134691/1089-134691-0001.flac
260,M,test-clean,1536,88240,86704,test-clean/260/123288/260-123288-0008.flac
8463,F,test-clean,0,86800,86800,test-clean/8463/287645/8463-287645-0012.flac
4446,F,test-clean,0,86960,86960,test-clean/4446/2273/4446-2273-0004.flac
4507,F,test-clean,0,86960,86960,test-clean/4507/16021/4507-16021-0036.flac
8224,M,test-clean,0,87040,87040,test-clean/8224/274384/8224-274384-0013.flac
121,F,test-clean,4096,91136,87040,test-clean/121/127105/121-127105-0005.flac
2830,M,test-clean,0,87040,87040,test-clean/2830/3980/2830-3980-0062.flac
4992,F,test-clean,0,87120,87120,test-clean/4992/41797/4992-41797-0011.flac
6829,F,test-clean,0,87200,87200,test-clean/6829/68771/6829-68771-0033.flac
5105,M,test-clean,0,87280,87280,test-clean/5105/28240/5105-28240-0000.flac
5683,F,test-clean,0,87280,87280,test-clean/5683/32865/5683-32865-0017.flac
5683,F,test-clean,0,87280,87280,test-clean/5683/32866/5683-32866-0018.flac
8555,F,test-clean,0,87360,87360,test-clean/8555/284447/8555-284447-0018.flac
7127,M,test-clean,0,87360,87360,test-clean/7127/75947/7127-75947-0007.flac
5142,F,test-clean,0,87520,87520,test-clean/5142/33396/5142-33396-0059.flac
7176,M,test-clean,0,87520,87520,test-clean/7176/92135/7176-92135-0005.flac
61,M,test-clean,0,87600,87600,test-clean/61/70968/61-70968-0019.flac
61,M,test-clean,0,87600,87600,test-clean/61/70970/61-70970-0026.flac
7729,M,test-clean,0,87760,87760,test-clean/7729/102255/7729-102255-0025.flac
8555,F,test-clean,0,87760,87760,test-clean/8555/284447/8555-284447-0004.flac
5142,F,test-clean,0,87760,87760,test-clean/5142/36377/5142-36377-0004.flac
4992,F,test-clean,0,87760,87760,test-clean/4992/41797/4992-41797-0000.flac
4446,F,test-clean,0,87920,87920,test-clean/4446/2275/4446-2275-0026.flac
4446,F,test-clean,0,87920,87920,test-clean/4446/2271/4446-2271-0008.flac
7729,M,test-clean,0,88000,88000,test-clean/7729/102255/7729-102255-0023.flac
5105,M,test-clean,0,88080,88080,test-clean/5105/28233/5105-28233-0006.flac
1580,F,test-clean,0,88080,88080,test-clean/1580/141083/1580-141083-0044.flac
5105,M,test-clean,0,88240,88240,test-clean/5105/28240/5105-28240-0003.flac
3729,F,test-clean,0,88240,88240,test-clean/3729/6852/3729-6852-0024.flac
2830,M,test-clean,0,88400,88400,test-clean/2830/3980/2830-3980-0011.flac
3575,F,test-clean,0,88480,88480,test-clean/3575/170457/3575-170457-0028.flac
7176,M,test-clean,0,88480,88480,test-clean/7176/88083/7176-88083-0026.flac
61,M,test-clean,0,88480,88480,test-clean/61/70968/61-70968-0061.flac
8455,M,test-clean,0,88560,88560,test-clean/8455/210777/8455-210777-0059.flac
1995,F,test-clean,4096,92672,88576,test-clean/1995/1836/1995-1836-0001.flac
2830,M,test-clean,0,88640,88640,test-clean/2830/3980/2830-3980-0038.flac
1320,M,test-clean,0,88640,88640,test-clean/1320/122612/1320-122612-0007.flac
4507,F,test-clean,0,88720,88720,test-clean/4507/16021/4507-16021-0033.flac
8455,M,test-clean,0,88720,88720,test-clean/8455/210777/8455-210777-0056.flac
3575,F,test-clean,0,88880,88880,test-clean/3575/170457/3575-170457-0048.flac
6829,F,test-clean,0,88880,88880,test-clean/6829/68769/6829-68769-0031.flac
2830,M,test-clean,0,88881,88881,test-clean/2830/3980/2830-3980-0069.flac
6930,M,test-clean,0,88960,88960,test-clean/6930/76324/6930-76324-0002.flac
5142,F,test-clean,0,89040,89040,test-clean/5142/33396/5142-33396-0067.flac
7127,M,test-clean,0,89120,89120,test-clean/7127/75947/7127-75947-0025.flac
5142,F,test-clean,0,89120,89120,test-clean/5142/33396/5142-33396-0051.flac
1995,F,test-clean,0,89280,89280,test-clean/1995/1837/1995-1837-0029.flac
61,M,test-clean,0,89280,89280,test-clean/61/70968/61-70968-0050.flac
121,F,test-clean,3072,92480,89408,test-clean/121/127105/121-127105-0011.flac
8455,M,test-clean,0,89440,89440,test-clean/8455/210777/8455-210777-0039.flac
1284,F,test-clean,0,89760,89760,test-clean/1284/1180/1284-1180-0023.flac
3570,F,test-clean,0,89760,89760,test-clean/3570/5694/3570-5694-0013.flac
4507,F,test-clean,0,89840,89840,test-clean/4507/16021/4507-16021-0011.flac
5142,F,test-clean,0,89920,89920,test-clean/5142/36377/5142-36377-0002.flac
5683,F,test-clean,0,89920,89920,test-clean/5683/32866/5683-32866-0028.flac
6829,F,test-clean,0,90000,90000,test-clean/6829/68771/6829-68771-0011.flac
4992,F,test-clean,0,90000,90000,test-clean/4992/41797/4992-41797-0002.flac
7729,M,test-clean,0,90000,90000,test-clean/7729/102255/7729-102255-0035.flac
2094,F,test-clean,0,90080,90080,test-clean/2094/142345/2094-142345-0027.flac
1995,F,test-clean,2560,92672,90112,test-clean/1995/1826/1995-1826-0016.flac
1089,M,test-clean,0,90160,90160,test-clean/1089/134691/1089-134691-0022.flac
260,M,test-clean,512,90720,90208,test-clean/260/123286/260-123286-0018.flac
5142,F,test-clean,2048,92480,90432,test-clean/5142/36377/5142-36377-0024.flac
1320,M,test-clean,0,90480,90480,test-clean/1320/122617/1320-122617-0017.flac
1320,M,test-clean,0,90480,90480,test-clean/1320/122617/1320-122617-0006.flac
7021,M,test-clean,0,90624,90624,test-clean/7021/79740/7021-79740-0006.flac
5105,M,test-clean,0,90640,90640,test-clean/5105/28240/5105-28240-0017.flac
3570,F,test-clean,0,90800,90800,test-clean/3570/5694/3570-5694-0001.flac
2094,F,test-clean,0,90880,90880,test-clean/2094/142345/2094-142345-0054.flac
4077,M,test-clean,0,90880,90880,test-clean/4077/13754/4077-13754-0003.flac
8455,M,test-clean,0,90960,90960,test-clean/8455/210777/8455-210777-0005.flac
61,M,test-clean,0,90960,90960,test-clean/61/70968/61-70968-0030.flac
61,M,test-clean,0,90960,90960,test-clean/61/70968/61-70968-0033.flac
1320,M,test-clean,0,91039,91039,test-clean/1320/122617/1320-122617-0027.flac
7176,M,test-clean,0,91120,91120,test-clean/7176/88083/7176-88083-0000.flac
2830,M,test-clean,0,91200,91200,test-clean/2830/3980/2830-3980-0074.flac
2961,F,test-clean,0,91280,91280,test-clean/2961/961/2961-961-0009.flac
3729,F,test-clean,0,91360,91360,test-clean/3729/6852/3729-6852-0014.flac
4446,F,test-clean,0,91440,91440,test-clean/4446/2271/4446-2271-0018.flac
6829,F,test-clean,0,91520,91520,test-clean/6829/68769/6829-68769-0032.flac
8463,F,test-clean,0,91600,91600,test-clean/8463/294828/8463-294828-0014.flac
4970,F,test-clean,1024,92672,91648,test-clean/4970/29093/4970-29093-0022.flac
1580,F,test-clean,0,91680,91680,test-clean/1580/141083/1580-141083-0037.flac
6829,F,test-clean,0,91760,91760,test-clean/6829/68769/6829-68769-0025.flac
5142,F,test-clean,0,91920,91920,test-clean/5142/33396/5142-33396-0054.flac
5142,F,test-clean,512,92640,92128,test-clean/5142/36377/5142-36377-0023.flac
121,F,test-clean,8192,100352,92160,test-clean/121/121726/121-121726-0007.flac
260,M,test-clean,0,92160,92160,test-clean/260/123286/260-123286-0023.flac
2830,M,test-clean,0,92240,92240,test-clean/2830/3980/2830-3980-0036.flac
8555,F,test-clean,0,92320,92320,test-clean/8555/292519/8555-292519-0010.flac
3729,F,test-clean,0,92320,92320,test-clean/3729/6852/3729-6852-0038.flac
8555,F,test-clean,0,92400,92400,test-clean/8555/284449/8555-284449-0013.flac
1284,F,test-clean,0,92480,92480,test-clean/1284/1180/1284-1180-0032.flac
2830,M,test-clean,0,92640,92640,test-clean/2830/3980/2830-3980-0075.flac
1995,F,test-clean,5120,97792,92672,test-clean/1995/1826/1995-1826-0020.flac
908,M,test-clean,0,92800,92800,test-clean/908/31957/908-31957-0007.flac
1089,M,test-clean,0,92960,92960,test-clean/1089/134686/1089-134686-0034.flac
4970,F,test-clean,0,92960,92960,test-clean/4970/29095/4970-29095-0034.flac
7176,M,test-clean,0,92960,92960,test-clean/7176/88083/7176-88083-0019.flac
1089,M,test-clean,0,93040,93040,test-clean/1089/134686/1089-134686-0015.flac
3575,F,test-clean,0,93200,93200,test-clean/3575/170457/3575-170457-0022.flac
1284,F,test-clean,0,93360,93360,test-clean/1284/1180/1284-1180-0015.flac
1221,F,test-clean,0,93600,93600,test-clean/1221/135767/1221-135767-0024.flac
6930,M,test-clean,0,93600,93600,test-clean/6930/75918/6930-75918-0006.flac
3575,F,test-clean,0,93601,93601,test-clean/3575/170457/3575-170457-0012.flac
4446,F,test-clean,0,93840,93840,test-clean/4446/2273/4446-2273-0022.flac
1221,F,test-clean,0,93840,93840,test-clean/1221/135767/1221-135767-0005.flac
1580,F,test-clean,0,93840,93840,test-clean/1580/141083/1580-141083-0042.flac
1284,F,test-clean,0,93920,93920,test-clean/1284/1180/1284-1180-0020.flac
4446,F,test-clean,0,94080,94080,test-clean/4446/2275/4446-2275-0043.flac
5142,F,test-clean,0,94080,94080,test-clean/5142/33396/5142-33396-0052.flac
8555,F,test-clean,0,94208,94208,test-clean/8555/284449/8555-284449-0016.flac
3729,F,test-clean,0,94240,94240,test-clean/3729/6852/3729-6852-0037.flac
908,M,test-clean,0,94240,94240,test-clean/908/31957/908-31957-0006.flac
908,M,test-clean,0,94320,94320,test-clean/908/31957/908-31957-0020.flac
1089,M,test-clean,0,94320,94320,test-clean/1089/134691/1089-134691-0006.flac
7729,M,test-clean,0,94480,94480,test-clean/7729/102255/7729-102255-0027.flac
1580,F,test-clean,0,94480,94480,test-clean/1580/141084/1580-141084-0002.flac
4507,F,test-clean,0,94560,94560,test-clean/4507/16021/4507-16021-0049.flac
1320,M,test-clean,0,94640,94640,test-clean/1320/122612/1320-122612-0005.flac
8463,F,test-clean,0,94640,94640,test-clean/8463/294828/8463-294828-0020.flac
6829,F,test-clean,0,94720,94720,test-clean/6829/68771/6829-68771-0006.flac
8455,M,test-clean,0,94800,94800,test-clean/8455/210777/8455-210777-0018.flac
8455,M,test-clean,0,95120,95120,test-clean/8455/210777/8455-210777-0070.flac
1995,F,test-clean,3072,98320,95248,test-clean/1995/1826/1995-1826-0017.flac
1580,F,test-clean,0,95360,95360,test-clean/1580/141084/1580-141084-0016.flac
8463,F,test-clean,0,95441,95441,test-clean/8463/294825/8463-294825-0012.flac
7127,M,test-clean,0,95680,95680,test-clean/7127/75947/7127-75947-0003.flac
61,M,test-clean,0,95680,95680,test-clean/61/70970/61-70970-0037.flac
8463,F,test-clean,0,95680,95680,test-clean/8463/294828/8463-294828-0027.flac
121,F,test-clean,8192,103936,95744,test-clean/121/121726/121-121726-0003.flac
1580,F,test-clean,0,95760,95760,test-clean/1580/141084/1580-141084-0040.flac
5105,M,test-clean,0,96240,96240,test-clean/5105/28240/5105-28240-0004.flac
4992,F,test-clean,0,96320,96320,test-clean/4992/41806/4992-41806-0013.flac
5105,M,test-clean,0,96320,96320,test-clean/5105/28240/5105-28240-0011.flac
61,M,test-clean,0,96400,96400,test-clean/61/70968/61-70968-0024.flac
4446,F,test-clean,0,96400,96400,test-clean/4446/2275/4446-2275-0012.flac
8555,F,test-clean,0,96400,96400,test-clean/8555/292519/8555-292519-0008.flac
4970,F,test-clean,0,96640,96640,test-clean/4970/29095/4970-29095-0024.flac
1284,F,test-clean,0,96720,96720,test-clean/1284/1180/1284-1180-0028.flac
6930,M,test-clean,0,96880,96880,test-clean/6930/81414/6930-81414-0008.flac
3575,F,test-clean,0,96880,96880,test-clean/3575/170457/3575-170457-0029.flac
6829,F,test-clean,0,96880,96880,test-clean/6829/68769/6829-68769-0034.flac
5683,F,test-clean,0,97040,97040,test-clean/5683/32865/5683-32865-0007.flac
61,M,test-clean,0,97200,97200,test-clean/61/70970/61-70970-0000.flac
61,M,test-clean,0,97200,97200,test-clean/61/70970/61-70970-0011.flac
1284,F,test-clean,0,97280,97280,test-clean/1284/1181/1284-1181-0008.flac
4970,F,test-clean,8192,105472,97280,test-clean/4970/29093/4970-29093-0007.flac
2300,M,test-clean,0,97280,97280,test-clean/2300/131720/2300-131720-0029.flac
2830,M,test-clean,0,97360,97360,test-clean/2830/3980/2830-3980-0066.flac
1188,M,test-clean,0,97520,97520,test-clean/1188/133604/1188-133604-0010.flac
5142,F,test-clean,0,97520,97520,test-clean/5142/33396/5142-33396-0042.flac
8463,F,test-clean,0,97600,97600,test-clean/8463/287645/8463-287645-0004.flac
4446,F,test-clean,0,97600,97600,test-clean/4446/2273/4446-2273-0023.flac
5683,F,test-clean,0,97760,97760,test-clean/5683/32879/5683-32879-0005.flac
4507,F,test-clean,0,97840,97840,test-clean/4507/16021/4507-16021-0014.flac
2830,M,test-clean,0,97920,97920,test-clean/2830/3979/2830-3979-0000.flac
5683,F,test-clean,0,97920,97920,test-clean/5683/32865/5683-32865-0008.flac
2094,F,test-clean,0,98000,98000,test-clean/2094/142345/2094-142345-0049.flac
2961,F,test-clean,0,98000,98000,test-clean/2961/961/2961-961-0020.flac
237,F,test-clean,0,98080,98080,test-clean/237/134500/237-134500-0000.flac
8555,F,test-clean,0,98160,98160,test-clean/8555/284449/8555-284449-0008.flac
1580,F,test-clean,0,98160,98160,test-clean/1580/141083/1580-141083-0002.flac
1995,F,test-clean,0,98304,98304,test-clean/1995/1826/1995-1826-0012.flac
260,M,test-clean,1536,99840,98304,test-clean/260/123288/260-123288-0027.flac
4446,F,test-clean,0,98400,98400,test-clean/4446/2273/4446-2273-0035.flac
6930,M,test-clean,0,98400,98400,test-clean/6930/76324/6930-76324-0004.flac
237,F,test-clean,0,98400,98400,test-clean/237/126133/237-126133-0006.flac
3575,F,test-clean,0,98480,98480,test-clean/3575/170457/3575-170457-0019.flac
61,M,test-clean,0,98480,98480,test-clean/61/70970/61-70970-0001.flac
2830,M,test-clean,0,98560,98560,test-clean/2830/3980/2830-3980-0023.flac
6930,M,test-clean,0,98560,98560,test-clean/6930/75918/6930-75918-0017.flac
6829,F,test-clean,0,98640,98640,test-clean/6829/68771/6829-68771-0005.flac
4507,F,test-clean,0,98720,98720,test-clean/4507/16021/4507-16021-0051.flac
908,M,test-clean,0,98880,98880,test-clean/908/31957/908-31957-0013.flac
5142,F,test-clean,0,98880,98880,test-clean/5142/36377/5142-36377-0007.flac
8463,F,test-clean,0,99040,99040,test-clean/8463/294828/8463-294828-0002.flac
8455,M,test-clean,0,99120,99120,test-clean/8455/210777/8455-210777-0040.flac
260,M,test-clean,0,99200,99200,test-clean/260/123440/260-123440-0015.flac
4507,F,test-clean,0,99200,99200,test-clean/4507/16021/4507-16021-0022.flac
4507,F,test-clean,0,99280,99280,test-clean/4507/16021/4507-16021-0059.flac
3729,F,test-clean,0,99360,99360,test-clean/3729/6852/3729-6852-0018.flac
237,F,test-clean,0,99360,99360,test-clean/237/126133/237-126133-0017.flac
7176,M,test-clean,0,99440,99440,test-clean/7176/92135/7176-92135-0023.flac
6829,F,test-clean,0,99600,99600,test-clean/6829/68771/6829-68771-0030.flac
8224,M,test-clean,0,99680,99680,test-clean/8224/274384/8224-274384-0007.flac
5142,F,test-clean,0,99680,99680,test-clean/5142/33396/5142-33396-0006.flac
121,F,test-clean,8192,108000,99808,test-clean/121/127105/121-127105-0028.flac
237,F,test-clean,0,99840,99840,test-clean/237/126133/237-126133-0010.flac
8455,M,test-clean,0,99840,99840,test-clean/8455/210777/8455-210777-0002.flac
5105,M,test-clean,0,99841,99841,test-clean/5105/28240/5105-28240-0019.flac
6829,F,test-clean,0,99920,99920,test-clean/6829/68771/6829-68771-0024.flac
8230,M,test-clean,0,100000,100000,test-clean/8230/279154/8230-279154-0011.flac
1580,F,test-clean,0,100000,100000,test-clean/1580/141083/1580-141083-0031.flac
7127,M,test-clean,0,100160,100160,test-clean/7127/75947/7127-75947-0015.flac
8230,M,test-clean,0,100240,100240,test-clean/8230/279154/8230-279154-0023.flac
1284,F,test-clean,0,100240,100240,test-clean/1284/1180/1284-1180-0007.flac
672,M,test-clean,0,100320,100320,test-clean/672/122797/672-122797-0070.flac
4507,F,test-clean,0,100400,100400,test-clean/4507/16021/4507-16021-0052.flac
4446,F,test-clean,0,100480,100480,test-clean/4446/2275/4446-2275-0029.flac
908,M,test-clean,0,100480,100480,test-clean/908/157963/908-157963-0010.flac
2094,F,test-clean,0,100480,100480,test-clean/2094/142345/2094-142345-0039.flac
1320,M,test-clean,0,100560,100560,test-clean/1320/122617/1320-122617-0031.flac
1284,F,test-clean,0,100560,100560,test-clean/1284/1180/1284-1180-0009.flac
5105,M,test-clean,0,100560,100560,test-clean/5105/28241/5105-28241-0016.flac
1320,M,test-clean,0,100560,100560,test-clean/1320/122617/1320-122617-0003.flac
121,F,test-clean,8192,109056,100864,test-clean/121/121726/121-121726-0009.flac
7021,M,test-clean,2560,103440,100880,test-clean/7021/79740/7021-79740-0004.flac
6930,M,test-clean,0,101040,101040,test-clean/6930/76324/6930-76324-0020.flac
5683,F,test-clean,0,101360,101360,test-clean/5683/32865/5683-32865-0010.flac
8230,M,test-clean,0,101440,101440,test-clean/8230/279154/8230-279154-0024.flac
4446,F,test-clean,0,101440,101440,test-clean/4446/2275/4446-2275-0000.flac
4507,F,test-clean,0,101520,101520,test-clean/4507/16021/4507-16021-0056.flac
5683,F,test-clean,0,101600,101600,test-clean/5683/32879/5683-32879-0019.flac
237,F,test-clean,0,101600,101600,test-clean/237/134500/237-134500-0033.flac
4446,F,test-clean,0,101600,101600,test-clean/4446/2271/4446-2271-0001.flac
5683,F,test-clean,0,101680,101680,test-clean/5683/32865/5683-32865-0011.flac
6829,F,test-clean,0,101760,101760,test-clean/6829/68769/6829-68769-0053.flac
1995,F,test-clean,0,101760,101760,test-clean/1995/1837/1995-1837-0004.flac
1320,M,test-clean,0,101760,101760,test-clean/1320/122617/1320-122617-0025.flac
8555,F,test-clean,0,101840,101840,test-clean/8555/284447/8555-284447-0007.flac
8463,F,test-clean,0,101840,101840,test-clean/8463/294828/8463-294828-0033.flac
8455,M,test-clean,0,101920,101920,test-clean/8455/210777/8455-210777-0041.flac
61,M,test-clean,0,102000,102000,test-clean/61/70968/61-70968-0011.flac
6930,M,test-clean,0,102080,102080,test-clean/6930/75918/6930-75918-0015.flac
8463,F,test-clean,0,102080,102080,test-clean/8463/287645/8463-287645-0011.flac
1320,M,test-clean,0,102160,102160,test-clean/1320/122612/1320-122612-0015.flac
2094,F,test-clean,0,102240,102240,test-clean/2094/142345/2094-142345-0048.flac
3575,F,test-clean,0,102480,102480,test-clean/3575/170457/3575-170457-0050.flac
2830,M,test-clean,0,102560,102560,test-clean/2830/3980/2830-3980-0006.flac
672,M,test-clean,0,102720,102720,test-clean/672/122797/672-122797-0007.flac
2830,M,test-clean,0,102720,102720,test-clean/2830/3980/2830-3980-0037.flac
1320,M,test-clean,0,102800,102800,test-clean/1320/122612/1320-122612-0004.flac
1995,F,test-clean,2560,105472,102912,test-clean/1995/1837/1995-1837-0027.flac
7021,M,test-clean,0,102912,102912,test-clean/7021/85628/7021-85628-0020.flac
4970,F,test-clean,0,102912,102912,test-clean/4970/29095/4970-29095-0032.flac
2300,M,test-clean,8192,111104,102912,test-clean/2300/131720/2300-131720-0036.flac
1284,F,test-clean,0,102960,102960,test-clean/1284/1181/1284-1181-0010.flac
8230,M,test-clean,0,103040,103040,test-clean/8230/279154/8230-279154-0022.flac
2830,M,test-clean,0,103040,103040,test-clean/2830/3980/2830-3980-0051.flac
2830,M,test-clean,0,103200,103200,test-clean/2830/3980/2830-3980-0005.flac
4992,F,test-clean,0,103200,103200,test-clean/4992/41797/4992-41797-0022.flac
5105,M,test-clean,0,103280,103280,test-clean/5105/28241/5105-28241-0000.flac
7021,M,test-clean,0,103280,103280,test-clean/7021/85628/7021-85628-0002.flac
5639,M,test-clean,5120,108544,103424,test-clean/5639/40744/5639-40744-0013.flac
4992,F,test-clean,512,103936,103424,test-clean/4992/23283/4992-23283-0019.flac
1580,F,test-clean,0,103520,103520,test-clean/1580/141084/1580-141084-0031.flac
7176,M,test-clean,0,103520,103520,test-clean/7176/92135/7176-92135-0036.flac
908,M,test-clean,0,103680,103680,test-clean/908/31957/908-31957-0016.flac
8224,M,test-clean,0,103680,103680,test-clean/8224/274381/8224-274381-0011.flac
6829,F,test-clean,0,103920,103920,test-clean/6829/68769/6829-68769-0048.flac
237,F,test-clean,0,104160,104160,test-clean/237/126133/237-126133-0005.flac
2830,M,test-clean,0,104240,104240,test-clean/2830/3980/2830-3980-0065.flac
7127,M,test-clean,0,104320,104320,test-clean/7127/75946/7127-75946-0020.flac
3575,F,test-clean,0,104320,104320,test-clean/3575/170457/3575-170457-0045.flac
6829,F,test-clean,0,104400,104400,test-clean/6829/68769/6829-68769-0015.flac
3575,F,test-clean,0,104400,104400,test-clean/3575/170457/3575-170457-0047.flac
2830,M,test-clean,0,104400,104400,test-clean/2830/3980/2830-3980-0010.flac
260,M,test-clean,8192,112640,104448,test-clean/260/123286/260-123286-0000.flac
7021,M,test-clean,2560,107008,104448,test-clean/7021/79740/7021-79740-0007.flac
2094,F,test-clean,0,104480,104480,test-clean/2094/142345/2094-142345-0052.flac
5683,F,test-clean,0,104720,104720,test-clean/5683/32879/5683-32879-0020.flac
1580,F,test-clean,0,104800,104800,test-clean/1580/141083/1580-141083-0003.flac
1284,F,test-clean,0,104800,104800,test-clean/1284/1180/1284-1180-0005.flac
1320,M,test-clean,0,104800,104800,test-clean/1320/122612/1320-122612-0013.flac
61,M,test-clean,0,104800,104800,test-clean/61/70970/61-70970-0028.flac
1089,M,test-clean,0,104800,104800,test-clean/1089/134686/1089-134686-0021.flac
237,F,test-clean,0,104800,104800,test-clean/237/134493/237-134493-0015.flac
6829,F,test-clean,0,104880,104880,test-clean/6829/68771/6829-68771-0032.flac
7127,M,test-clean,0,104880,104880,test-clean/7127/75947/7127-75947-0026.flac
672,M,test-clean,0,104880,104880,test-clean/672/122797/672-122797-0048.flac
8230,M,test-clean,0,104960,104960,test-clean/8230/279154/8230-279154-0021.flac
4992,F,test-clean,0,104960,104960,test-clean/4992/23283/4992-23283-0018.flac
4970,F,test-clean,0,104960,104960,test-clean/4970/29095/4970-29095-0037.flac
237,F,test-clean,0,104960,104960,test-clean/237/126133/237-126133-0003.flac
1995,F,test-clean,1536,106496,104960,test-clean/1995/1836/1995-1836-0009.flac
672,M,test-clean,0,104960,104960,test-clean/672/122797/672-122797-0057.flac
908,M,test-clean,0,105040,105040,test-clean/908/31957/908-31957-0003.flac
5142,F,test-clean,0,105360,105360,test-clean/5142/36377/5142-36377-0013.flac
237,F,test-clean,0,105600,105600,test-clean/237/134500/237-134500-0036.flac
1089,M,test-clean,0,105760,105760,test-clean/1089/134686/1089-134686-0025.flac
5142,F,test-clean,0,105840,105840,test-clean/5142/33396/5142-33396-0034.flac
1089,M,test-clean,0,105840,105840,test-clean/1089/134686/1089-134686-0031.flac
1089,M,test-clean,0,106000,106000,test-clean/1089/134686/1089-134686-0002.flac
1188,M,test-clean,0,106000,106000,test-clean/1188/133604/1188-133604-0039.flac
1188,M,test-clean,0,106000,106000,test-clean/1188/133604/1188-133604-0033.flac
260,M,test-clean,0,106080,106080,test-clean/260/123440/260-123440-0019.flac
8455,M,test-clean,0,106080,106080,test-clean/8455/210777/8455-210777-0011.flac
4992,F,test-clean,0,106080,106080,test-clean/4992/23283/4992-23283-0013.flac
7127,M,test-clean,0,106240,106240,test-clean/7127/75947/7127-75947-0001.flac
4992,F,test-clean,0,106320,106320,test-clean/4992/23283/4992-23283-0000.flac
61,M,test-clean,0,106640,106640,test-clean/61/70970/61-70970-0039.flac
8463,F,test-clean,0,106640,106640,test-clean/8463/287645/8463-287645-0013.flac
237,F,test-clean,0,106800,106800,test-clean/237/126133/237-126133-0023.flac
3575,F,test-clean,0,106880,106880,test-clean/3575/170457/3575-170457-0014.flac
237,F,test-clean,0,107360,107360,test-clean/237/126133/237-126133-0011.flac
6829,F,test-clean,0,107520,107520,test-clean/6829/68769/6829-68769-0005.flac
7021,M,test-clean,3072,110592,107520,test-clean/7021/85628/7021-85628-0008.flac
4077,M,test-clean,0,107520,107520,test-clean/4077/13751/4077-13751-0010.flac
1089,M,test-clean,0,107680,107680,test-clean/1089/134686/1089-134686-0008.flac
4992,F,test-clean,0,107680,107680,test-clean/4992/41806/4992-41806-0012.flac
3575,F,test-clean,0,107680,107680,test-clean/3575/170457/3575-170457-0009.flac
1284,F,test-clean,0,107680,107680,test-clean/1284/1181/1284-1181-0020.flac
61,M,test-clean,0,107760,107760,test-clean/61/70968/61-70968-0043.flac
7176,M,test-clean,0,107840,107840,test-clean/7176/88083/7176-88083-0010.flac
7729,M,test-clean,0,108000,108000,test-clean/7729/102255/7729-102255-0031.flac
7176,M,test-clean,0,108080,108080,test-clean/7176/92135/7176-92135-0015.flac
5105,M,test-clean,0,108400,108400,test-clean/5105/28241/5105-28241-0012.flac
7729,M,test-clean,0,108400,108400,test-clean/7729/102255/7729-102255-0033.flac
8224,M,test-clean,512,108960,108448,test-clean/8224/274384/8224-274384-0006.flac
4970,F,test-clean,2560,111104,108544,test-clean/4970/29095/4970-29095-0016.flac
61,M,test-clean,0,108560,108560,test-clean/61/70970/61-70970-0036.flac
237,F,test-clean,0,108640,108640,test-clean/237/126133/237-126133-0014.flac
5683,F,test-clean,0,108720,108720,test-clean/5683/32879/5683-32879-0007.flac
1580,F,test-clean,0,108720,108720,test-clean/1580/141084/1580-141084-0008.flac
6930,M,test-clean,0,108800,108800,test-clean/6930/81414/6930-81414-0006.flac
7729,M,test-clean,0,108880,108880,test-clean/7729/102255/7729-102255-0045.flac
2961,F,test-clean,0,109040,109040,test-clean/2961/961/2961-961-0015.flac
237,F,test-clean,0,109040,109040,test-clean/237/126133/237-126133-0013.flac
7729,M,test-clean,0,109040,109040,test-clean/7729/102255/7729-102255-0039.flac
4992,F,test-clean,0,109120,109120,test-clean/4992/41797/4992-41797-0010.flac
61,M,test-clean,0,109200,109200,test-clean/61/70968/61-70968-0041.flac
237,F,test-clean,0,109200,109200,test-clean/237/134493/237-134493-0004.flac
8555,F,test-clean,0,109280,109280,test-clean/8555/284447/8555-284447-0005.flac
2094,F,test-clean,0,109440,109440,test-clean/2094/142345/2094-142345-0028.flac
3570,F,test-clean,0,109520,109520,test-clean/3570/5695/3570-5695-0008.flac
1284,F,test-clean,0,109840,109840,test-clean/1284/1180/1284-1180-0006.flac
61,M,test-clean,0,109920,109920,test-clean/61/70968/61-70968-0027.flac
260,M,test-clean,0,110080,110080,test-clean/260/123286/260-123286-0016.flac
2961,F,test-clean,0,110240,110240,test-clean/2961/960/2961-960-0012.flac
2300,M,test-clean,0,110400,110400,test-clean/2300/131720/2300-131720-0005.flac
4992,F,test-clean,0,110480,110480,test-clean/4992/41797/4992-41797-0007.flac
3575,F,test-clean,0,110480,110480,test-clean/3575/170457/3575-170457-0040.flac
7021,M,test-clean,3072,113664,110592,test-clean/7021/79740/7021-79740-0013.flac
2094,F,test-clean,0,110640,110640,test-clean/2094/142345/2094-142345-0036.flac
260,M,test-clean,0,111040,111040,test-clean/260/123286/260-123286-0026.flac
1995,F,test-clean,512,111616,111104,test-clean/1995/1836/1995-1836-0008.flac
8455,M,test-clean,0,111280,111280,test-clean/8455/210777/8455-210777-0053.flac
4446,F,test-clean,0,111440,111440,test-clean/4446/2275/4446-2275-0040.flac
5639,M,test-clean,0,111616,111616,test-clean/5639/40744/5639-40744-0029.flac
4970,F,test-clean,2560,114176,111616,test-clean/4970/29093/4970-29093-0019.flac
121,F,test-clean,5632,117248,111616,test-clean/121/127105/121-127105-0034.flac
3729,F,test-clean,0,111680,111680,test-clean/3729/6852/3729-6852-0044.flac
8463,F,test-clean,0,111760,111760,test-clean/8463/294828/8463-294828-0036.flac
1580,F,test-clean,0,111840,111840,test-clean/1580/141083/1580-141083-0034.flac
6829,F,test-clean,0,111840,111840,test-clean/6829/68771/6829-68771-0016.flac
1580,F,test-clean,0,111920,111920,test-clean/1580/141084/1580-141084-0026.flac
1580,F,test-clean,0,112000,112000,test-clean/1580/141084/1580-141084-0033.flac
260,M,test-clean,512,112640,112128,test-clean/260/123288/260-123288-0002.flac
1995,F,test-clean,512,112640,112128,test-clean/1995/1826/1995-1826-0007.flac
5105,M,test-clean,0,112160,112160,test-clean/5105/28241/5105-28241-0009.flac
3575,F,test-clean,0,112240,112240,test-clean/3575/170457/3575-170457-0011.flac
2830,M,test-clean,0,112240,112240,test-clean/2830/3980/2830-3980-0019.flac
8555,F,test-clean,0,112480,112480,test-clean/8555/284449/8555-284449-0018.flac
908,M,test-clean,0,112560,112560,test-clean/908/157963/908-157963-0005.flac
1580,F,test-clean,0,112640,112640,test-clean/1580/141083/1580-141083-0009.flac
260,M,test-clean,2560,115200,112640,test-clean/260/123286/260-123286-0028.flac
1320,M,test-clean,0,112880,112880,test-clean/1320/122617/1320-122617-0039.flac
4446,F,test-clean,0,112960,112960,test-clean/4446/2275/4446-2275-0033.flac
7729,M,test-clean,0,112960,112960,test-clean/7729/102255/7729-102255-0029.flac
1580,F,test-clean,0,113040,113040,test-clean/1580/141083/1580-141083-0012.flac
1221,F,test-clean,0,113120,113120,test-clean/1221/135767/1221-135767-0014.flac
260,M,test-clean,4096,117248,113152,test-clean/260/123286/260-123286-0006.flac
8455,M,test-clean,0,113200,113200,test-clean/8455/210777/8455-210777-0060.flac
5142,F,test-clean,0,113360,113360,test-clean/5142/36377/5142-36377-0005.flac
5683,F,test-clean,0,113520,113520,test-clean/5683/32865/5683-32865-0013.flac
3570,F,test-clean,2560,116160,113600,test-clean/3570/5696/3570-5696-0008.flac
237,F,test-clean,0,113680,113680,test-clean/237/134500/237-134500-0037.flac
6829,F,test-clean,0,113760,113760,test-clean/6829/68769/6829-68769-0018.flac
121,F,test-clean,3072,116960,113888,test-clean/121/127105/121-127105-0029.flac
2830,M,test-clean,0,113920,113920,test-clean/2830/3980/2830-3980-0061.flac
237,F,test-clean,0,113920,113920,test-clean/237/126133/237-126133-0019.flac
1995,F,test-clean,5632,119808,114176,test-clean/1995/1826/1995-1826-0009.flac
6829,F,test-clean,0,114320,114320,test-clean/6829/68769/6829-68769-0004.flac
1284,F,test-clean,0,114400,114400,test-clean/1284/1181/1284-1181-0004.flac
8555,F,test-clean,0,114480,114480,test-clean/8555/284447/8555-284447-0023.flac
2961,F,test-clean,0,114480,114480,test-clean/2961/961/2961-961-0008.flac
8455,M,test-clean,0,114560,114560,test-clean/8455/210777/8455-210777-0058.flac
7176,M,test-clean,0,114640,114640,test-clean/7176/92135/7176-92135-0020.flac
4970,F,test-clean,6656,121344,114688,test-clean/4970/29093/4970-29093-0013.flac
7176,M,test-clean,0,114720,114720,test-clean/7176/92135/7176-92135-0017.flac
8455,M,test-clean,0,114720,114720,test-clean/8455/210777/8455-210777-0044.flac
260,M,test-clean,0,114720,114720,test-clean/260/123286/260-123286-0027.flac
1320,M,test-clean,0,114880,114880,test-clean/1320/122617/1320-122617-0037.flac
6829,F,test-clean,0,114880,114880,test-clean/6829/68771/6829-68771-0008.flac
1995,F,test-clean,0,115040,115040,test-clean/1995/1837/1995-1837-0016.flac
6829,F,test-clean,0,115040,115040,test-clean/6829/68771/6829-68771-0013.flac
6829,F,test-clean,0,115120,115120,test-clean/6829/68769/6829-68769-0006.flac
8463,F,test-clean,0,115200,115200,test-clean/8463/294828/8463-294828-0013.flac
121,F,test-clean,3072,118272,115200,test-clean/121/127105/121-127105-0003.flac
4992,F,test-clean,0,115440,115440,test-clean/4992/41797/4992-41797-0014.flac
2830,M,test-clean,0,115520,115520,test-clean/2830/3980/2830-3980-0032.flac
4507,F,test-clean,0,115600,115600,test-clean/4507/16021/4507-16021-0055.flac
61,M,test-clean,0,115760,115760,test-clean/61/70970/61-70970-0024.flac
7729,M,test-clean,0,116000,116000,test-clean/7729/102255/7729-102255-0030.flac
7176,M,test-clean,0,116320,116320,test-clean/7176/92135/7176-92135-0042.flac
121,F,test-clean,4096,120480,116384,test-clean/121/127105/121-127105-0026.flac
6930,M,test-clean,0,116480,116480,test-clean/6930/75918/6930-75918-0009.flac
8230,M,test-clean,0,116480,116480,test-clean/8230/279154/8230-279154-0030.flac
260,M,test-clean,0,116736,116736,test-clean/260/123286/260-123286-0003.flac
4446,F,test-clean,0,116800,116800,test-clean/4446/2275/4446-2275-0016.flac
4992,F,test-clean,0,117040,117040,test-clean/4992/41797/4992-41797-0004.flac
8463,F,test-clean,0,117120,117120,test-clean/8463/294828/8463-294828-0006.flac
6930,M,test-clean,0,117200,117200,test-clean/6930/81414/6930-81414-0013.flac
7127,M,test-clean,0,117280,117280,test-clean/7127/75947/7127-75947-0024.flac
2830,M,test-clean,0,117360,117360,test-clean/2830/3980/2830-3980-0055.flac
3575,F,test-clean,0,117440,117440,test-clean/3575/170457/3575-170457-0005.flac
2094,F,test-clean,0,117600,117600,test-clean/2094/142345/2094-142345-0043.flac
6930,M,test-clean,0,117680,117680,test-clean/6930/76324/6930-76324-0021.flac
1995,F,test-clean,0,117760,117760,test-clean/1995/1837/1995-1837-0003.flac
5683,F,test-clean,0,117840,117840,test-clean/5683/32865/5683-32865-0004.flac
3729,F,test-clean,0,117920,117920,test-clean/3729/6852/3729-6852-0011.flac
5683,F,test-clean,0,117920,117920,test-clean/5683/32866/5683-32866-0011.flac
7176,M,test-clean,0,118080,118080,test-clean/7176/88083/7176-88083-0025.flac
237,F,test-clean,0,118080,118080,test-clean/237/134493/237-134493-0001.flac
6829,F,test-clean,0,118400,118400,test-clean/6829/68769/6829-68769-0049.flac
5105,M,test-clean,0,118400,118400,test-clean/5105/28240/5105-28240-0005.flac
61,M,test-clean,0,118480,118480,test-clean/61/70970/61-70970-0035.flac
6930,M,test-clean,0,118560,118560,test-clean/6930/81414/6930-81414-0014.flac
8455,M,test-clean,0,118560,118560,test-clean/8455/210777/8455-210777-0013.flac
6829,F,test-clean,0,118720,118720,test-clean/6829/68771/6829-68771-0019.flac
260,M,test-clean,0,118784,118784,test-clean/260/123286/260-123286-0030.flac
2961,F,test-clean,0,118800,118800,test-clean/2961/960/2961-960-0022.flac
61,M,test-clean,0,118960,118960,test-clean/61/70970/61-70970-0025.flac
5683,F,test-clean,0,119040,119040,test-clean/5683/32879/5683-32879-0018.flac
1221,F,test-clean,0,119040,119040,test-clean/1221/135766/1221-135766-0004.flac
1188,M,test-clean,0,119200,119200,test-clean/1188/133604/1188-133604-0025.flac
1580,F,test-clean,0,119200,119200,test-clean/1580/141083/1580-141083-0033.flac
121,F,test-clean,0,119296,119296,test-clean/121/127105/121-127105-0002.flac
7127,M,test-clean,0,119360,119360,test-clean/7127/75947/7127-75947-0028.flac
1320,M,test-clean,0,119360,119360,test-clean/1320/122612/1320-122612-0002.flac
3570,F,test-clean,0,119520,119520,test-clean/3570/5695/3570-5695-0006.flac
2830,M,test-clean,0,119600,119600,test-clean/2830/3980/2830-3980-0050.flac
7127,M,test-clean,0,119680,119680,test-clean/7127/75947/7127-75947-0016.flac
61,M,test-clean,0,119760,119760,test-clean/61/70968/61-70968-0014.flac
4992,F,test-clean,0,119840,119840,test-clean/4992/41797/4992-41797-0020.flac
7176,M,test-clean,0,120000,120000,test-clean/7176/88083/7176-88083-0004.flac
8230,M,test-clean,0,120160,120160,test-clean/8230/279154/8230-279154-0006.flac
8455,M,test-clean,0,120160,120160,test-clean/8455/210777/8455-210777-0033.flac
7176,M,test-clean,0,120160,120160,test-clean/7176/88083/7176-88083-0002.flac
3570,F,test-clean,0,120160,120160,test-clean/3570/5696/3570-5696-0002.flac
7127,M,test-clean,0,120240,120240,test-clean/7127/75946/7127-75946-0015.flac
1580,F,test-clean,0,120560,120560,test-clean/1580/141083/1580-141083-0038.flac
4507,F,test-clean,0,120560,120560,test-clean/4507/16021/4507-16021-0035.flac
908,M,test-clean,0,120640,120640,test-clean/908/31957/908-31957-0024.flac
7176,M,test-clean,0,120720,120720,test-clean/7176/92135/7176-92135-0016.flac
4446,F,test-clean,0,120800,120800,test-clean/4446/2271/4446-2271-0020.flac
5105,M,test-clean,0,120800,120800,test-clean/5105/28241/5105-28241-0006.flac
1995,F,test-clean,2560,123392,120832,test-clean/1995/1836/1995-1836-0006.flac
8230,M,test-clean,0,120880,120880,test-clean/8230/279154/8230-279154-0035.flac
1320,M,test-clean,0,120880,120880,test-clean/1320/122617/1320-122617-0024.flac
7176,M,test-clean,0,120960,120960,test-clean/7176/92135/7176-92135-0001.flac
8455,M,test-clean,0,120960,120960,test-clean/8455/210777/8455-210777-0024.flac
908,M,test-clean,0,120960,120960,test-clean/908/31957/908-31957-0014.flac
3570,F,test-clean,0,121120,121120,test-clean/3570/5696/3570-5696-0010.flac
1580,F,test-clean,0,121200,121200,test-clean/1580/141084/1580-141084-0049.flac
8555,F,test-clean,5632,126976,121344,test-clean/8555/284447/8555-284447-0002.flac
5639,M,test-clean,0,121344,121344,test-clean/5639/40744/5639-40744-0014.flac
1320,M,test-clean,0,121440,121440,test-clean/1320/122617/1320-122617-0012.flac
672,M,test-clean,0,121440,121440,test-clean/672/122797/672-122797-0061.flac
3575,F,test-clean,0,121520,121520,test-clean/3575/170457/3575-170457-0003.flac
7176,M,test-clean,0,121600,121600,test-clean/7176/88083/7176-88083-0003.flac
8224,M,test-clean,0,121680,121680,test-clean/8224/274384/8224-274384-0000.flac
8555,F,test-clean,0,121760,121760,test-clean/8555/284449/8555-284449-0019.flac
908,M,test-clean,0,121840,121840,test-clean/908/31957/908-31957-0012.flac
1995,F,test-clean,3584,125440,121856,test-clean/1995/1836/1995-1836-0003.flac
2961,F,test-clean,0,122240,122240,test-clean/2961/960/2961-960-0007.flac
4077,M,test-clean,0,122400,122400,test-clean/4077/13754/4077-13754-0009.flac
8455,M,test-clean,0,122720,122720,test-clean/8455/210777/8455-210777-0031.flac
4446,F,test-clean,0,122800,122800,test-clean/4446/2275/4446-2275-0002.flac
1284,F,test-clean,0,122880,122880,test-clean/1284/1180/1284-1180-0002.flac
8463,F,test-clean,0,123200,123200,test-clean/8463/294825/8463-294825-0005.flac
8455,M,test-clean,0,123200,123200,test-clean/8455/210777/8455-210777-0034.flac
908,M,test-clean,0,123280,123280,test-clean/908/31957/908-31957-0009.flac
1320,M,test-clean,0,123280,123280,test-clean/1320/122617/1320-122617-0009.flac
7729,M,test-clean,0,123280,123280,test-clean/7729/102255/7729-102255-0036.flac
8463,F,test-clean,0,123360,123360,test-clean/8463/287645/8463-287645-0006.flac
2300,M,test-clean,2048,125440,123392,test-clean/2300/131720/2300-131720-0037.flac
4446,F,test-clean,0,123440,123440,test-clean/4446/2273/4446-2273-0008.flac
8230,M,test-clean,0,123520,123520,test-clean/8230/279154/8230-279154-0005.flac
1089,M,test-clean,0,123760,123760,test-clean/1089/134691/1089-134691-0023.flac
8455,M,test-clean,0,123760,123760,test-clean/8455/210777/8455-210777-0028.flac
4970,F,test-clean,0,123904,123904,test-clean/4970/29093/4970-29093-0023.flac
4970,F,test-clean,8704,132608,123904,test-clean/4970/29093/4970-29093-0012.flac
1284,F,test-clean,0,124000,124000,test-clean/1284/1181/1284-1181-0011.flac
5683,F,test-clean,0,124000,124000,test-clean/5683/32879/5683-32879-0010.flac
1284,F,test-clean,0,124080,124080,test-clean/1284/1180/1284-1180-0001.flac
2961,F,test-clean,0,124160,124160,test-clean/2961/960/2961-960-0016.flac
8463,F,test-clean,0,124240,124240,test-clean/8463/294828/8463-294828-0031.flac
672,M,test-clean,0,124240,124240,test-clean/672/122797/672-122797-0012.flac
3575,F,test-clean,0,124400,124400,test-clean/3575/170457/3575-170457-0007.flac
1995,F,test-clean,3584,128000,124416,test-clean/1995/1837/1995-1837-0026.flac
908,M,test-clean,0,124720,124720,test-clean/908/31957/908-31957-0017.flac
7176,M,test-clean,0,124720,124720,test-clean/7176/92135/7176-92135-0006.flac
3570,F,test-clean,0,124880,124880,test-clean/3570/5695/3570-5695-0002.flac
8463,F,test-clean,0,124880,124880,test-clean/8463/294825/8463-294825-0001.flac
2961,F,test-clean,0,125040,125040,test-clean/2961/961/2961-961-0011.flac
3570,F,test-clean,0,125040,125040,test-clean/3570/5694/3570-5694-0018.flac
1320,M,test-clean,0,125040,125040,test-clean/1320/122617/1320-122617-0023.flac
2961,F,test-clean,0,125040,125040,test-clean/2961/961/2961-961-0016.flac
4446,F,test-clean,0,125120,125120,test-clean/4446/2271/4446-2271-0009.flac
2961,F,test-clean,0,125280,125280,test-clean/2961/961/2961-961-0010.flac
6829,F,test-clean,0,125280,125280,test-clean/6829/68771/6829-68771-0025.flac
2961,F,test-clean,0,125280,125280,test-clean/2961/960/2961-960-0015.flac
1089,M,test-clean,0,125280,125280,test-clean/1089/134686/1089-134686-0028.flac
1320,M,test-clean,0,125360,125360,test-clean/1320/122617/1320-122617-0000.flac
8230,M,test-clean,0,125360,125360,test-clean/8230/279154/8230-279154-0020.flac
4446,F,test-clean,0,125360,125360,test-clean/4446/2273/4446-2273-0003.flac
4446,F,test-clean,0,125360,125360,test-clean/4446/2273/4446-2273-0032.flac
4992,F,test-clean,0,125440,125440,test-clean/4992/41806/4992-41806-0011.flac
8455,M,test-clean,0,125440,125440,test-clean/8455/210777/8455-210777-0004.flac
5142,F,test-clean,0,125520,125520,test-clean/5142/33396/5142-33396-0031.flac
61,M,test-clean,0,125760,125760,test-clean/61/70968/61-70968-0054.flac
2830,M,test-clean,0,125840,125840,test-clean/2830/3980/2830-3980-0047.flac
2961,F,test-clean,0,125920,125920,test-clean/2961/960/2961-960-0017.flac
121,F,test-clean,2560,128512,125952,test-clean/121/121726/121-121726-0000.flac
1320,M,test-clean,0,126000,126000,test-clean/1320/122617/1320-122617-0029.flac
1320,M,test-clean,0,126000,126000,test-clean/1320/122612/1320-122612-0008.flac
6829,F,test-clean,0,126320,126320,test-clean/6829/68769/6829-68769-0021.flac
5683,F,test-clean,0,126400,126400,test-clean/5683/32866/5683-32866-0021.flac
8463,F,test-clean,0,126480,126480,test-clean/8463/287645/8463-287645-0003.flac
8463,F,test-clean,0,126640,126640,test-clean/8463/294828/8463-294828-0028.flac
1089,M,test-clean,0,126640,126640,test-clean/1089/134686/1089-134686-0013.flac
7729,M,test-clean,0,126720,126720,test-clean/7729/102255/7729-102255-0038.flac
1284,F,test-clean,0,126720,126720,test-clean/1284/1181/1284-1181-0014.flac
8230,M,test-clean,0,126880,126880,test-clean/8230/279154/8230-279154-0017.flac
7729,M,test-clean,0,126880,126880,test-clean/7729/102255/7729-102255-0021.flac
672,M,test-clean,0,127040,127040,test-clean/672/122797/672-122797-0072.flac
8230,M,test-clean,0,127040,127040,test-clean/8230/279154/8230-279154-0014.flac
3570,F,test-clean,0,127200,127200,test-clean/3570/5695/3570-5695-0015.flac
61,M,test-clean,0,127200,127200,test-clean/61/70968/61-70968-0035.flac
7021,M,test-clean,0,127488,127488,test-clean/7021/79730/7021-79730-0005.flac
1188,M,test-clean,0,127520,127520,test-clean/1188/133604/1188-133604-0036.flac
1320,M,test-clean,0,127600,127600,test-clean/1320/122617/1320-122617-0040.flac
7127,M,test-clean,0,127680,127680,test-clean/7127/75946/7127-75946-0006.flac
1580,F,test-clean,0,127840,127840,test-clean/1580/141084/1580-141084-0041.flac
2094,F,test-clean,0,127840,127840,test-clean/2094/142345/2094-142345-0034.flac
1089,M,test-clean,0,128080,128080,test-clean/1089/134691/1089-134691-0025.flac
3575,F,test-clean,0,128080,128080,test-clean/3575/170457/3575-170457-0054.flac
7021,M,test-clean,0,128240,128240,test-clean/7021/85628/7021-85628-0010.flac
2094,F,test-clean,0,128480,128480,test-clean/2094/142345/2094-142345-0001.flac
5639,M,test-clean,0,128720,128720,test-clean/5639/40744/5639-40744-0006.flac
8230,M,test-clean,0,128800,128800,test-clean/8230/279154/8230-279154-0015.flac
4992,F,test-clean,0,128960,128960,test-clean/4992/23283/4992-23283-0004.flac
2830,M,test-clean,0,129120,129120,test-clean/2830/3980/2830-3980-0057.flac
1580,F,test-clean,0,129200,129200,test-clean/1580/141084/1580-141084-0029.flac
2830,M,test-clean,0,129360,129360,test-clean/2830/3979/2830-3979-0003.flac
7127,M,test-clean,0,129440,129440,test-clean/7127/75947/7127-75947-0027.flac
4507,F,test-clean,0,129520,129520,test-clean/4507/16021/4507-16021-0053.flac
908,M,test-clean,0,129600,129600,test-clean/908/157963/908-157963-0026.flac
8455,M,test-clean,0,129680,129680,test-clean/8455/210777/8455-210777-0019.flac
908,M,test-clean,0,129760,129760,test-clean/908/157963/908-157963-0006.flac
3570,F,test-clean,3584,133360,129776,test-clean/3570/5694/3570-5694-0017.flac
1284,F,test-clean,0,129920,129920,test-clean/1284/1180/1284-1180-0000.flac
3570,F,test-clean,0,130048,130048,test-clean/3570/5694/3570-5694-0005.flac
2830,M,test-clean,0,130080,130080,test-clean/2830/3980/2830-3980-0067.flac
1995,F,test-clean,0,130240,130240,test-clean/1995/1826/1995-1826-0023.flac
3729,F,test-clean,0,130960,130960,test-clean/3729/6852/3729-6852-0023.flac
7021,M,test-clean,0,131072,131072,test-clean/7021/85628/7021-85628-0018.flac
7176,M,test-clean,0,131120,131120,test-clean/7176/88083/7176-88083-0024.flac
5105,M,test-clean,0,131200,131200,test-clean/5105/28240/5105-28240-0024.flac
1221,F,test-clean,0,131200,131200,test-clean/1221/135767/1221-135767-0010.flac
672,M,test-clean,0,131280,131280,test-clean/672/122797/672-122797-0073.flac
2961,F,test-clean,0,131520,131520,test-clean/2961/960/2961-960-0004.flac
3570,F,test-clean,0,131584,131584,test-clean/3570/5695/3570-5695-0011.flac
4992,F,test-clean,0,131680,131680,test-clean/4992/41797/4992-41797-0021.flac
7176,M,test-clean,0,131680,131680,test-clean/7176/92135/7176-92135-0022.flac
1320,M,test-clean,0,131680,131680,test-clean/1320/122617/1320-122617-0019.flac
672,M,test-clean,0,131680,131680,test-clean/672/122797/672-122797-0055.flac
3575,F,test-clean,0,131680,131680,test-clean/3575/170457/3575-170457-0000.flac
1995,F,test-clean,0,131920,131920,test-clean/1995/1837/1995-1837-0012.flac
61,M,test-clean,0,132000,132000,test-clean/61/70968/61-70968-0049.flac
2961,F,test-clean,0,132001,132001,test-clean/2961/960/2961-960-0001.flac
5639,M,test-clean,4608,136704,132096,test-clean/5639/40744/5639-40744-0025.flac
1995,F,test-clean,5120,137216,132096,test-clean/1995/1826/1995-1826-0011.flac
5683,F,test-clean,0,132160,132160,test-clean/5683/32866/5683-32866-0012.flac
6930,M,test-clean,0,132320,132320,test-clean/6930/76324/6930-76324-0027.flac
5105,M,test-clean,0,132560,132560,test-clean/5105/28233/5105-28233-0002.flac
1284,F,test-clean,0,132640,132640,test-clean/1284/1180/1284-1180-0026.flac
61,M,test-clean,0,132720,132720,test-clean/61/70968/61-70968-0010.flac
7729,M,test-clean,0,132800,132800,test-clean/7729/102255/7729-102255-0002.flac
3575,F,test-clean,0,132800,132800,test-clean/3575/170457/3575-170457-0006.flac
4992,F,test-clean,0,132960,132960,test-clean/4992/41806/4992-41806-0001.flac
260,M,test-clean,0,133040,133040,test-clean/260/123440/260-123440-0010.flac
3729,F,test-clean,0,133040,133040,test-clean/3729/6852/3729-6852-0022.flac
1995,F,test-clean,7680,140800,133120,test-clean/1995/1836/1995-1836-0000.flac
2300,M,test-clean,2048,135168,133120,test-clean/2300/131720/2300-131720-0034.flac
8463,F,test-clean,0,133440,133440,test-clean/8463/294828/8463-294828-0010.flac
2830,M,test-clean,0,133600,133600,test-clean/2830/3979/2830-3979-0009.flac
2961,F,test-clean,0,134080,134080,test-clean/2961/960/2961-960-0018.flac
7021,M,test-clean,512,134656,134144,test-clean/7021/85628/7021-85628-0027.flac
8555,F,test-clean,0,134240,134240,test-clean/8555/284447/8555-284447-0008.flac
4992,F,test-clean,0,134320,134320,test-clean/4992/23283/4992-23283-0009.flac
5683,F,test-clean,0,134480,134480,test-clean/5683/32879/5683-32879-0014.flac
8555,F,test-clean,0,134480,134480,test-clean/8555/292519/8555-292519-0007.flac
61,M,test-clean,0,134640,134640,test-clean/61/70970/61-70970-0015.flac
5105,M,test-clean,0,134640,134640,test-clean/5105/28241/5105-28241-0005.flac
260,M,test-clean,5120,139776,134656,test-clean/260/123288/260-123288-0003.flac
2300,M,test-clean,3072,137920,134848,test-clean/2300/131720/2300-131720-0027.flac
5639,M,test-clean,6656,141520,134864,test-clean/5639/40744/5639-40744-0024.flac
3570,F,test-clean,0,134960,134960,test-clean/3570/5694/3570-5694-0015.flac
5639,M,test-clean,2560,137520,134960,test-clean/5639/40744/5639-40744-0012.flac
6829,F,test-clean,0,135040,135040,test-clean/6829/68771/6829-68771-0004.flac
6829,F,test-clean,0,135120,135120,test-clean/6829/68771/6829-68771-0018.flac
8555,F,test-clean,0,135520,135520,test-clean/8555/284447/8555-284447-0014.flac
4970,F,test-clean,512,136192,135680,test-clean/4970/29095/4970-29095-0038.flac
2830,M,test-clean,0,135760,135760,test-clean/2830/3980/2830-3980-0031.flac
3575,F,test-clean,0,136000,136000,test-clean/3575/170457/3575-170457-0033.flac
2961,F,test-clean,0,136080,136080,test-clean/2961/961/2961-961-0007.flac
1284,F,test-clean,0,136160,136160,test-clean/1284/1181/1284-1181-0012.flac
5639,M,test-clean,1024,137216,136192,test-clean/5639/40744/5639-40744-0002.flac
7021,M,test-clean,0,136192,136192,test-clean/7021/85628/7021-85628-0009.flac
908,M,test-clean,0,136240,136240,test-clean/908/31957/908-31957-0023.flac
2094,F,test-clean,0,136400,136400,test-clean/2094/142345/2094-142345-0029.flac
5105,M,test-clean,0,136400,136400,test-clean/5105/28240/5105-28240-0015.flac
1284,F,test-clean,0,136480,136480,test-clean/1284/134647/1284-134647-0000.flac
260,M,test-clean,7168,143680,136512,test-clean/260/123288/260-123288-0011.flac
8230,M,test-clean,0,136640,136640,test-clean/8230/279154/8230-279154-0029.flac
5105,M,test-clean,0,136640,136640,test-clean/5105/28241/5105-28241-0008.flac
7729,M,test-clean,0,136640,136640,test-clean/7729/102255/7729-102255-0010.flac
1188,M,test-clean,0,136960,136960,test-clean/1188/133604/1188-133604-0005.flac
7127,M,test-clean,0,137280,137280,test-clean/7127/75946/7127-75946-0013.flac
3729,F,test-clean,0,137680,137680,test-clean/3729/6852/3729-6852-0029.flac
8555,F,test-clean,0,137728,137728,test-clean/8555/284447/8555-284447-0001.flac
8455,M,test-clean,0,137840,137840,test-clean/8455/210777/8455-210777-0015.flac
8555,F,test-clean,0,138080,138080,test-clean/8555/284449/8555-284449-0001.flac
1284,F,test-clean,0,138160,138160,test-clean/1284/1180/1284-1180-0010.flac
4970,F,test-clean,4608,142848,138240,test-clean/4970/29093/4970-29093-0009.flac
3575,F,test-clean,0,138320,138320,test-clean/3575/170457/3575-170457-0020.flac
4992,F,test-clean,0,138400,138400,test-clean/4992/41797/4992-41797-0015.flac
5639,M,test-clean,6656,145408,138752,test-clean/5639/40744/5639-40744-0033.flac
237,F,test-clean,0,138880,138880,test-clean/237/126133/237-126133-0007.flac
4992,F,test-clean,0,139040,139040,test-clean/4992/41797/4992-41797-0017.flac
3570,F,test-clean,2560,141760,139200,test-clean/3570/5696/3570-5696-0009.flac
1284,F,test-clean,0,139280,139280,test-clean/1284/1180/1284-1180-0025.flac
672,M,test-clean,0,139280,139280,test-clean/672/122797/672-122797-0013.flac
1995,F,test-clean,0,139680,139680,test-clean/1995/1837/1995-1837-0001.flac
672,M,test-clean,0,139680,139680,test-clean/672/122797/672-122797-0074.flac
1580,F,test-clean,0,139760,139760,test-clean/1580/141084/1580-141084-0023.flac
4077,M,test-clean,0,139920,139920,test-clean/4077/13751/4077-13751-0001.flac
8455,M,test-clean,0,139920,139920,test-clean/8455/210777/8455-210777-0000.flac
8224,M,test-clean,0,139920,139920,test-clean/8224/274384/8224-274384-0005.flac
1995,F,test-clean,0,140320,140320,test-clean/1995/1826/1995-1826-0013.flac
2961,F,test-clean,0,140400,140400,test-clean/2961/960/2961-960-0014.flac
3729,F,test-clean,0,140480,140480,test-clean/3729/6852/3729-6852-0002.flac
1221,F,test-clean,0,140720,140720,test-clean/1221/135766/1221-135766-0007.flac
2830,M,test-clean,0,140720,140720,test-clean/2830/3980/2830-3980-0025.flac
1995,F,test-clean,0,140800,140800,test-clean/1995/1837/1995-1837-0007.flac
672,M,test-clean,0,140800,140800,test-clean/672/122797/672-122797-0038.flac
8230,M,test-clean,0,140880,140880,test-clean/8230/279154/8230-279154-0000.flac
7127,M,test-clean,0,141199,141199,test-clean/7127/75947/7127-75947-0037.flac
672,M,test-clean,0,141200,141200,test-clean/672/122797/672-122797-0020.flac
3729,F,test-clean,0,141200,141200,test-clean/3729/6852/3729-6852-0039.flac
121,F,test-clean,8192,149504,141312,test-clean/121/121726/121-121726-0010.flac
7021,M,test-clean,0,141824,141824,test-clean/7021/85628/7021-85628-0011.flac
7127,M,test-clean,0,141840,141840,test-clean/7127/75947/7127-75947-0010.flac
7127,M,test-clean,0,141840,141840,test-clean/7127/75947/7127-75947-0033.flac
1089,M,test-clean,0,141920,141920,test-clean/1089/134686/1089-134686-0017.flac
2300,M,test-clean,0,142000,142000,test-clean/2300/131720/2300-131720-0015.flac
672,M,test-clean,0,142000,142000,test-clean/672/122797/672-122797-0071.flac
8555,F,test-clean,0,142000,142000,test-clean/8555/284449/8555-284449-0003.flac
8555,F,test-clean,2560,144640,142080,test-clean/8555/284447/8555-284447-0013.flac
1320,M,test-clean,0,142320,142320,test-clean/1320/122617/1320-122617-0020.flac
2300,M,test-clean,3072,145408,142336,test-clean/2300/131720/2300-131720-0008.flac
8455,M,test-clean,0,142640,142640,test-clean/8455/210777/8455-210777-0069.flac
237,F,test-clean,0,142720,142720,test-clean/237/126133/237-126133-0002.flac
237,F,test-clean,0,142720,142720,test-clean/237/134500/237-134500-0041.flac
5683,F,test-clean,0,142720,142720,test-clean/5683/32879/5683-32879-0000.flac
1995,F,test-clean,3072,145920,142848,test-clean/1995/1826/1995-1826-0000.flac
7729,M,test-clean,0,142880,142880,test-clean/7729/102255/7729-102255-0019.flac
7021,M,test-clean,1536,144480,142944,test-clean/7021/85628/7021-85628-0023.flac
7176,M,test-clean,0,143040,143040,test-clean/7176/92135/7176-92135-0018.flac
6829,F,test-clean,0,143040,143040,test-clean/6829/68771/6829-68771-0002.flac
1580,F,test-clean,0,143040,143040,test-clean/1580/141083/1580-141083-0000.flac
6829,F,test-clean,0,143120,143120,test-clean/6829/68771/6829-68771-0029.flac
3575,F,test-clean,0,143121,143121,test-clean/3575/170457/3575-170457-0030.flac
4992,F,test-clean,0,143440,143440,test-clean/4992/41797/4992-41797-0008.flac
4446,F,test-clean,0,143600,143600,test-clean/4446/2275/4446-2275-0007.flac
1995,F,test-clean,1024,144720,143696,test-clean/1995/1836/1995-1836-0014.flac
4446,F,test-clean,0,143920,143920,test-clean/4446/2273/4446-2273-0000.flac
1580,F,test-clean,0,144080,144080,test-clean/1580/141084/1580-141084-0004.flac
1188,M,test-clean,0,144640,144640,test-clean/1188/133604/1188-133604-0001.flac
7021,M,test-clean,0,144896,144896,test-clean/7021/79740/7021-79740-0002.flac
1089,M,test-clean,0,144960,144960,test-clean/1089/134691/1089-134691-0016.flac
2830,M,test-clean,0,145200,145200,test-clean/2830/3980/2830-3980-0029.flac
2094,F,test-clean,0,145440,145440,test-clean/2094/142345/2094-142345-0005.flac
3575,F,test-clean,0,145520,145520,test-clean/3575/170457/3575-170457-0023.flac
237,F,test-clean,0,145680,145680,test-clean/237/134493/237-134493-0017.flac
7127,M,test-clean,0,146240,146240,test-clean/7127/75946/7127-75946-0018.flac
4992,F,test-clean,0,146480,146480,test-clean/4992/41797/4992-41797-0018.flac
3575,F,test-clean,0,146800,146800,test-clean/3575/170457/3575-170457-0013.flac
5639,M,test-clean,4096,151040,146944,test-clean/5639/40744/5639-40744-0016.flac
2961,F,test-clean,0,146960,146960,test-clean/2961/961/2961-961-0001.flac
1580,F,test-clean,0,146960,146960,test-clean/1580/141084/1580-141084-0024.flac
8463,F,test-clean,0,147040,147040,test-clean/8463/294828/8463-294828-0001.flac
6930,M,test-clean,0,147280,147280,test-clean/6930/76324/6930-76324-0016.flac
3575,F,test-clean,0,147280,147280,test-clean/3575/170457/3575-170457-0025.flac
260,M,test-clean,0,147280,147280,test-clean/260/123286/260-123286-0025.flac
7176,M,test-clean,0,147280,147280,test-clean/7176/92135/7176-92135-0038.flac
5683,F,test-clean,0,147360,147360,test-clean/5683/32879/5683-32879-0011.flac
4507,F,test-clean,0,147440,147440,test-clean/4507/16021/4507-16021-0025.flac
672,M,test-clean,0,147440,147440,test-clean/672/122797/672-122797-0016.flac
4970,F,test-clean,0,147456,147456,test-clean/4970/29095/4970-29095-0004.flac
5639,M,test-clean,7168,154624,147456,test-clean/5639/40744/5639-40744-0020.flac
5683,F,test-clean,0,147600,147600,test-clean/5683/32866/5683-32866-0004.flac
7729,M,test-clean,0,147600,147600,test-clean/7729/102255/7729-102255-0042.flac
6930,M,test-clean,0,147840,147840,test-clean/6930/76324/6930-76324-0011.flac
4992,F,test-clean,0,147840,147840,test-clean/4992/41806/4992-41806-0003.flac
1580,F,test-clean,0,148240,148240,test-clean/1580/141084/1580-141084-0048.flac
908,M,test-clean,0,148240,148240,test-clean/908/157963/908-157963-0025.flac
7127,M,test-clean,0,148560,148560,test-clean/7127/75946/7127-75946-0029.flac
8230,M,test-clean,0,148800,148800,test-clean/8230/279154/8230-279154-0026.flac
8463,F,test-clean,0,148800,148800,test-clean/8463/294828/8463-294828-0017.flac
8555,F,test-clean,0,148960,148960,test-clean/8555/284449/8555-284449-0007.flac
3570,F,test-clean,1024,150016,148992,test-clean/3570/5696/3570-5696-0007.flac
6829,F,test-clean,0,149040,149040,test-clean/6829/68769/6829-68769-0001.flac
8455,M,test-clean,0,149280,149280,test-clean/8455/210777/8455-210777-0046.flac
237,F,test-clean,0,149440,149440,test-clean/237/126133/237-126133-0015.flac
8463,F,test-clean,0,149440,149440,test-clean/8463/294828/8463-294828-0003.flac
121,F,test-clean,512,150016,149504,test-clean/121/123859/121-123859-0004.flac
1995,F,test-clean,1536,151040,149504,test-clean/1995/1837/1995-1837-0025.flac
4970,F,test-clean,0,149504,149504,test-clean/4970/29093/4970-29093-0018.flac
5683,F,test-clean,0,149520,149520,test-clean/5683/32879/5683-32879-0003.flac
3575,F,test-clean,0,149920,149920,test-clean/3575/170457/3575-170457-0035.flac
2830,M,test-clean,0,151040,151040,test-clean/2830/3979/2830-3979-0008.flac
3570,F,test-clean,0,151040,151040,test-clean/3570/5694/3570-5694-0008.flac
2300,M,test-clean,2560,153680,151120,test-clean/2300/131720/2300-131720-0009.flac
2830,M,test-clean,0,151200,151200,test-clean/2830/3979/2830-3979-0011.flac
8555,F,test-clean,6656,157920,151264,test-clean/8555/284449/8555-284449-0012.flac
121,F,test-clean,6144,157696,151552,test-clean/121/127105/121-127105-0000.flac
4970,F,test-clean,5120,156720,151600,test-clean/4970/29095/4970-29095-0027.flac
1320,M,test-clean,0,151760,151760,test-clean/1320/122617/1320-122617-0034.flac
7176,M,test-clean,0,151760,151760,test-clean/7176/88083/7176-88083-0022.flac
260,M,test-clean,7680,159760,152080,test-clean/260/123286/260-123286-0002.flac
1284,F,test-clean,0,152240,152240,test-clean/1284/1181/1284-1181-0016.flac
1320,M,test-clean,0,152320,152320,test-clean/1320/122612/1320-122612-0001.flac
908,M,test-clean,0,152640,152640,test-clean/908/31957/908-31957-0019.flac
8455,M,test-clean,0,152880,152880,test-clean/8455/210777/8455-210777-0055.flac
4077,M,test-clean,0,152960,152960,test-clean/4077/13751/4077-13751-0000.flac
6930,M,test-clean,0,152960,152960,test-clean/6930/81414/6930-81414-0004.flac
2961,F,test-clean,0,153040,153040,test-clean/2961/961/2961-961-0014.flac
8555,F,test-clean,0,153200,153200,test-clean/8555/292519/8555-292519-0005.flac
2300,M,test-clean,2560,156160,153600,test-clean/2300/131720/2300-131720-0030.flac
7729,M,test-clean,0,153600,153600,test-clean/7729/102255/7729-102255-0028.flac
8555,F,test-clean,0,153680,153680,test-clean/8555/284447/8555-284447-0000.flac
260,M,test-clean,6144,159920,153776,test-clean/260/123288/260-123288-0010.flac
908,M,test-clean,0,154000,154000,test-clean/908/157963/908-157963-0023.flac
1188,M,test-clean,0,154080,154080,test-clean/1188/133604/1188-133604-0022.flac
1089,M,test-clean,0,154160,154160,test-clean/1089/134686/1089-134686-0005.flac
7176,M,test-clean,0,154240,154240,test-clean/7176/92135/7176-92135-0031.flac
7176,M,test-clean,0,154320,154320,test-clean/7176/88083/7176-88083-0023.flac
4446,F,test-clean,0,154320,154320,test-clean/4446/2273/4446-2273-0016.flac
237,F,test-clean,0,154640,154640,test-clean/237/126133/237-126133-0024.flac
7127,M,test-clean,0,154800,154800,test-clean/7127/75946/7127-75946-0027.flac
1320,M,test-clean,0,155120,155120,test-clean/1320/122617/1320-122617-0018.flac
672,M,test-clean,0,155121,155121,test-clean/672/122797/672-122797-0023.flac
3575,F,test-clean,0,155520,155520,test-clean/3575/170457/3575-170457-0044.flac
4970,F,test-clean,512,156160,155648,test-clean/4970/29095/4970-29095-0003.flac
2961,F,test-clean,0,155680,155680,test-clean/2961/961/2961-961-0017.flac
4077,M,test-clean,0,156000,156000,test-clean/4077/13751/4077-13751-0002.flac
3570,F,test-clean,0,156080,156080,test-clean/3570/5695/3570-5695-0007.flac
1995,F,test-clean,3072,159232,156160,test-clean/1995/1826/1995-1826-0001.flac
1320,M,test-clean,0,156160,156160,test-clean/1320/122617/1320-122617-0011.flac
5142,F,test-clean,0,156560,156560,test-clean/5142/33396/5142-33396-0032.flac
4992,F,test-clean,0,156800,156800,test-clean/4992/41797/4992-41797-0013.flac
908,M,test-clean,0,156800,156800,test-clean/908/157963/908-157963-0020.flac
8224,M,test-clean,0,157040,157040,test-clean/8224/274384/8224-274384-0002.flac
6829,F,test-clean,0,157120,157120,test-clean/6829/68771/6829-68771-0010.flac
1284,F,test-clean,0,157440,157440,test-clean/1284/1180/1284-1180-0021.flac
5683,F,test-clean,0,157680,157680,test-clean/5683/32866/5683-32866-0024.flac
1320,M,test-clean,0,157840,157840,test-clean/1320/122612/1320-122612-0003.flac
7127,M,test-clean,0,157920,157920,test-clean/7127/75946/7127-75946-0012.flac
6930,M,test-clean,0,158000,158000,test-clean/6930/76324/6930-76324-0028.flac
2961,F,test-clean,0,158080,158080,test-clean/2961/960/2961-960-0020.flac
5683,F,test-clean,0,158240,158240,test-clean/5683/32865/5683-32865-0009.flac
2300,M,test-clean,2560,161280,158720,test-clean/2300/131720/2300-131720-0020.flac
5683,F,test-clean,0,158880,158880,test-clean/5683/32866/5683-32866-0013.flac
8463,F,test-clean,0,158960,158960,test-clean/8463/294825/8463-294825-0003.flac
4992,F,test-clean,1024,160768,159744,test-clean/4992/23283/4992-23283-0020.flac
1320,M,test-clean,0,160000,160000,test-clean/1320/122617/1320-122617-0010.flac
908,M,test-clean,0,160080,160080,test-clean/908/31957/908-31957-0008.flac
2094,F,test-clean,0,160160,160160,test-clean/2094/142345/2094-142345-0059.flac
6930,M,test-clean,0,160240,160240,test-clean/6930/75918/6930-75918-0016.flac
8455,M,test-clean,0,160480,160480,test-clean/8455/210777/8455-210777-0038.flac
121,F,test-clean,4096,164864,160768,test-clean/121/127105/121-127105-0031.flac
1580,F,test-clean,0,160880,160880,test-clean/1580/141083/1580-141083-0029.flac
7176,M,test-clean,0,160960,160960,test-clean/7176/88083/7176-88083-0011.flac
1188,M,test-clean,0,161120,161120,test-clean/1188/133604/1188-133604-0041.flac
7127,M,test-clean,0,161120,161120,test-clean/7127/75947/7127-75947-0039.flac
2094,F,test-clean,0,161280,161280,test-clean/2094/142345/2094-142345-0057.flac
2830,M,test-clean,0,161360,161360,test-clean/2830/3980/2830-3980-0054.flac
1320,M,test-clean,0,161360,161360,test-clean/1320/122617/1320-122617-0016.flac
237,F,test-clean,0,161360,161360,test-clean/237/134493/237-134493-0016.flac
8224,M,test-clean,0,161360,161360,test-clean/8224/274381/8224-274381-0007.flac
908,M,test-clean,0,161440,161440,test-clean/908/157963/908-157963-0012.flac
4970,F,test-clean,2560,164352,161792,test-clean/4970/29093/4970-29093-0002.flac
7127,M,test-clean,0,161840,161840,test-clean/7127/75947/7127-75947-0014.flac
5683,F,test-clean,0,161920,161920,test-clean/5683/32865/5683-32865-0005.flac
1284,F,test-clean,0,162480,162480,test-clean/1284/134647/1284-134647-0006.flac
7127,M,test-clean,0,162800,162800,test-clean/7127/75946/7127-75946-0014.flac
8555,F,test-clean,0,162880,162880,test-clean/8555/292519/8555-292519-0006.flac
5683,F,test-clean,0,162960,162960,test-clean/5683/32879/5683-32879-0016.flac
1221,F,test-clean,0,163040,163040,test-clean/1221/135766/1221-135766-0009.flac
2830,M,test-clean,0,163040,163040,test-clean/2830/3980/2830-3980-0007.flac
1320,M,test-clean,0,163120,163120,test-clean/1320/122612/1320-122612-0010.flac
4446,F,test-clean,0,163280,163280,test-clean/4446/2271/4446-2271-0016.flac
3570,F,test-clean,5120,168720,163600,test-clean/3570/5694/3570-5694-0007.flac
7729,M,test-clean,0,163680,163680,test-clean/7729/102255/7729-102255-0024.flac
7021,M,test-clean,1024,164864,163840,test-clean/7021/79740/7021-79740-0011.flac
908,M,test-clean,0,163840,163840,test-clean/908/157963/908-157963-0021.flac
672,M,test-clean,0,164000,164000,test-clean/672/122797/672-122797-0004.flac
1580,F,test-clean,0,164080,164080,test-clean/1580/141083/1580-141083-0001.flac
1188,M,test-clean,0,164160,164160,test-clean/1188/133604/1188-133604-0020.flac
8555,F,test-clean,0,164352,164352,test-clean/8555/284447/8555-284447-0019.flac
1284,F,test-clean,0,164400,164400,test-clean/1284/134647/1284-134647-0001.flac
4077,M,test-clean,0,164720,164720,test-clean/4077/13751/4077-13751-0020.flac
121,F,test-clean,5632,171008,165376,test-clean/121/123859/121-123859-0003.flac
7176,M,test-clean,0,165520,165520,test-clean/7176/92135/7176-92135-0040.flac
6829,F,test-clean,0,165680,165680,test-clean/6829/68771/6829-68771-0001.flac
2961,F,test-clean,0,165680,165680,test-clean/2961/960/2961-960-0005.flac
4992,F,test-clean,0,165920,165920,test-clean/4992/41806/4992-41806-0006.flac
4507,F,test-clean,0,166000,166000,test-clean/4507/16021/4507-16021-0042.flac
908,M,test-clean,0,166320,166320,test-clean/908/157963/908-157963-0011.flac
61,M,test-clean,0,166400,166400,test-clean/61/70970/61-70970-0038.flac
1089,M,test-clean,0,166960,166960,test-clean/1089/134686/1089-134686-0000.flac
4507,F,test-clean,0,167040,167040,test-clean/4507/16021/4507-16021-0013.flac
2830,M,test-clean,0,167040,167040,test-clean/2830/3980/2830-3980-0048.flac
7176,M,test-clean,0,167200,167200,test-clean/7176/88083/7176-88083-0018.flac
1320,M,test-clean,0,167840,167840,test-clean/1320/122612/1320-122612-0012.flac
1284,F,test-clean,0,167840,167840,test-clean/1284/1180/1284-1180-0008.flac
2094,F,test-clean,0,167840,167840,test-clean/2094/142345/2094-142345-0037.flac
61,M,test-clean,0,168240,168240,test-clean/61/70970/61-70970-0004.flac
3570,F,test-clean,0,168640,168640,test-clean/3570/5695/3570-5695-0014.flac
4077,M,test-clean,0,168880,168880,test-clean/4077/13751/4077-13751-0008.flac
1089,M,test-clean,0,168880,168880,test-clean/1089/134686/1089-134686-0006.flac
3570,F,test-clean,0,168880,168880,test-clean/3570/5694/3570-5694-0021.flac
237,F,test-clean,0,168960,168960,test-clean/237/134500/237-134500-0013.flac
8463,F,test-clean,0,168960,168960,test-clean/8463/294825/8463-294825-0002.flac
5639,M,test-clean,3072,172032,168960,test-clean/5639/40744/5639-40744-0021.flac
2961,F,test-clean,0,169200,169200,test-clean/2961/960/2961-960-0013.flac
1089,M,test-clean,0,169200,169200,test-clean/1089/134686/1089-134686-0009.flac
4507,F,test-clean,0,169360,169360,test-clean/4507/16021/4507-16021-0017.flac
3570,F,test-clean,0,169600,169600,test-clean/3570/5695/3570-5695-0004.flac
8230,M,test-clean,0,169600,169600,test-clean/8230/279154/8230-279154-0016.flac
237,F,test-clean,0,169760,169760,test-clean/237/134500/237-134500-0031.flac
3570,F,test-clean,0,169840,169840,test-clean/3570/5694/3570-5694-0002.flac
2300,M,test-clean,0,169984,169984,test-clean/2300/131720/2300-131720-0021.flac
121,F,test-clean,2560,172544,169984,test-clean/121/127105/121-127105-0023.flac
1188,M,test-clean,0,170400,170400,test-clean/1188/133604/1188-133604-0004.flac
1995,F,test-clean,2048,172544,170496,test-clean/1995/1836/1995-1836-0005.flac
3729,F,test-clean,0,170560,170560,test-clean/3729/6852/3729-6852-0040.flac
1284,F,test-clean,0,170880,170880,test-clean/1284/1180/1284-1180-0017.flac
2300,M,test-clean,0,171008,171008,test-clean/2300/131720/2300-131720-0023.flac
672,M,test-clean,0,171040,171040,test-clean/672/122797/672-122797-0025.flac
5639,M,test-clean,5120,176320,171200,test-clean/5639/40744/5639-40744-0015.flac
8455,M,test-clean,0,171520,171520,test-clean/8455/210777/8455-210777-0003.flac
4970,F,test-clean,0,171520,171520,test-clean/4970/29095/4970-29095-0026.flac
1188,M,test-clean,0,171600,171600,test-clean/1188/133604/1188-133604-0000.flac
5105,M,test-clean,0,171680,171680,test-clean/5105/28233/5105-28233-0008.flac
4992,F,test-clean,0,171840,171840,test-clean/4992/23283/4992-23283-0005.flac
1320,M,test-clean,0,172080,172080,test-clean/1320/122617/1320-122617-0013.flac
1221,F,test-clean,0,172480,172480,test-clean/1221/135766/1221-135766-0008.flac
8455,M,test-clean,0,172960,172960,test-clean/8455/210777/8455-210777-0057.flac
6930,M,test-clean,0,172960,172960,test-clean/6930/75918/6930-75918-0018.flac
237,F,test-clean,0,173040,173040,test-clean/237/134500/237-134500-0015.flac
2300,M,test-clean,0,173120,173120,test-clean/2300/131720/2300-131720-0010.flac
2300,M,test-clean,4608,178176,173568,test-clean/2300/131720/2300-131720-0012.flac
1580,F,test-clean,0,173600,173600,test-clean/1580/141083/1580-141083-0006.flac
2300,M,test-clean,7168,181248,174080,test-clean/2300/131720/2300-131720-0032.flac
4992,F,test-clean,0,174320,174320,test-clean/4992/41806/4992-41806-0017.flac
3729,F,test-clean,0,174320,174320,test-clean/3729/6852/3729-6852-0041.flac
908,M,test-clean,0,174480,174480,test-clean/908/31957/908-31957-0021.flac
237,F,test-clean,0,174960,174960,test-clean/237/134500/237-134500-0012.flac
7127,M,test-clean,0,175040,175040,test-clean/7127/75946/7127-75946-0022.flac
7021,M,test-clean,2048,177152,175104,test-clean/7021/79740/7021-79740-0000.flac
237,F,test-clean,0,175120,175120,test-clean/237/134493/237-134493-0005.flac
5105,M,test-clean,0,175360,175360,test-clean/5105/28241/5105-28241-0002.flac
4077,M,test-clean,0,175520,175520,test-clean/4077/13754/4077-13754-0014.flac
7729,M,test-clean,0,175600,175600,test-clean/7729/102255/7729-102255-0020.flac
5639,M,test-clean,2560,178176,175616,test-clean/5639/40744/5639-40744-0037.flac
7021,M,test-clean,0,175616,175616,test-clean/7021/79730/7021-79730-0006.flac
1188,M,test-clean,0,175760,175760,test-clean/1188/133604/1188-133604-0032.flac
7729,M,test-clean,0,176320,176320,test-clean/7729/102255/7729-102255-0037.flac
3570,F,test-clean,0,176480,176480,test-clean/3570/5694/3570-5694-0011.flac
7729,M,test-clean,0,176560,176560,test-clean/7729/102255/7729-102255-0043.flac
260,M,test-clean,0,176640,176640,test-clean/260/123288/260-123288-0007.flac
1320,M,test-clean,0,176720,176720,test-clean/1320/122617/1320-122617-0033.flac
6930,M,test-clean,0,177040,177040,test-clean/6930/75918/6930-75918-0004.flac
8555,F,test-clean,0,177200,177200,test-clean/8555/284449/8555-284449-0002.flac
5683,F,test-clean,0,177360,177360,test-clean/5683/32879/5683-32879-0002.flac
1995,F,test-clean,4608,182560,177952,test-clean/1995/1826/1995-1826-0021.flac
8230,M,test-clean,0,178160,178160,test-clean/8230/279154/8230-279154-0027.flac
8463,F,test-clean,0,178160,178160,test-clean/8463/294825/8463-294825-0006.flac
1221,F,test-clean,0,178560,178560,test-clean/1221/135767/1221-135767-0018.flac
4970,F,test-clean,6144,184832,178688,test-clean/4970/29093/4970-29093-0001.flac
3729,F,test-clean,0,178720,178720,test-clean/3729/6852/3729-6852-0000.flac
1089,M,test-clean,0,178800,178800,test-clean/1089/134686/1089-134686-0022.flac
260,M,test-clean,8192,187392,179200,test-clean/260/123286/260-123286-0019.flac
7127,M,test-clean,0,179360,179360,test-clean/7127/75946/7127-75946-0016.flac
5683,F,test-clean,0,179360,179360,test-clean/5683/32879/5683-32879-0004.flac
260,M,test-clean,0,179712,179712,test-clean/260/123288/260-123288-0013.flac
5142,F,test-clean,0,179920,179920,test-clean/5142/36377/5142-36377-0022.flac
1188,M,test-clean,0,179920,179920,test-clean/1188/133604/1188-133604-0027.flac
3570,F,test-clean,0,180080,180080,test-clean/3570/5694/3570-5694-0014.flac
7127,M,test-clean,0,180160,180160,test-clean/7127/75947/7127-75947-0038.flac
4507,F,test-clean,0,180320,180320,test-clean/4507/16021/4507-16021-0034.flac
1320,M,test-clean,0,180480,180480,test-clean/1320/122617/1320-122617-0032.flac
8455,M,test-clean,0,180560,180560,test-clean/8455/210777/8455-210777-0045.flac
4507,F,test-clean,0,180880,180880,test-clean/4507/16021/4507-16021-0009.flac
908,M,test-clean,0,181040,181040,test-clean/908/31957/908-31957-0001.flac
4507,F,test-clean,0,181120,181120,test-clean/4507/16021/4507-16021-0001.flac
7021,M,test-clean,0,181280,181280,test-clean/7021/85628/7021-85628-0001.flac
7729,M,test-clean,0,181600,181600,test-clean/7729/102255/7729-102255-0018.flac
4970,F,test-clean,8704,190464,181760,test-clean/4970/29095/4970-29095-0018.flac
5105,M,test-clean,0,182240,182240,test-clean/5105/28233/5105-28233-0005.flac
5639,M,test-clean,0,182272,182272,test-clean/5639/40744/5639-40744-0036.flac
237,F,test-clean,0,182320,182320,test-clean/237/134493/237-134493-0002.flac
1284,F,test-clean,0,182480,182480,test-clean/1284/1181/1284-1181-0006.flac
1221,F,test-clean,0,182640,182640,test-clean/1221/135766/1221-135766-0006.flac
4992,F,test-clean,0,182640,182640,test-clean/4992/41806/4992-41806-0007.flac
3570,F,test-clean,0,182640,182640,test-clean/3570/5696/3570-5696-0000.flac
4970,F,test-clean,0,182784,182784,test-clean/4970/29093/4970-29093-0011.flac
4077,M,test-clean,0,182800,182800,test-clean/4077/13751/4077-13751-0011.flac
1284,F,test-clean,0,182880,182880,test-clean/1284/1181/1284-1181-0001.flac
6829,F,test-clean,4096,187120,183024,test-clean/6829/68769/6829-68769-0000.flac
2961,F,test-clean,0,183680,183680,test-clean/2961/961/2961-961-0004.flac
5105,M,test-clean,0,183680,183680,test-clean/5105/28240/5105-28240-0008.flac
7021,M,test-clean,0,183840,183840,test-clean/7021/79730/7021-79730-0001.flac
5683,F,test-clean,0,183920,183920,test-clean/5683/32879/5683-32879-0013.flac
260,M,test-clean,8192,192320,184128,test-clean/260/123440/260-123440-0004.flac
7729,M,test-clean,0,184480,184480,test-clean/7729/102255/7729-102255-0007.flac
3575,F,test-clean,0,184560,184560,test-clean/3575/170457/3575-170457-0038.flac
7021,M,test-clean,0,184720,184720,test-clean/7021/85628/7021-85628-0015.flac
1188,M,test-clean,0,184799,184799,test-clean/1188/133604/1188-133604-0018.flac
8230,M,test-clean,0,184960,184960,test-clean/8230/279154/8230-279154-0028.flac
1089,M,test-clean,0,185600,185600,test-clean/1089/134691/1089-134691-0002.flac
7729,M,test-clean,0,185760,185760,test-clean/7729/102255/7729-102255-0016.flac
8555,F,test-clean,0,185920,185920,test-clean/8555/284447/8555-284447-0017.flac
7021,M,test-clean,2048,188240,186192,test-clean/7021/79730/7021-79730-0008.flac
1089,M,test-clean,0,186240,186240,test-clean/1089/134686/1089-134686-0012.flac
6930,M,test-clean,0,186321,186321,test-clean/6930/75918/6930-75918-0019.flac
5105,M,test-clean,0,186400,186400,test-clean/5105/28240/5105-28240-0009.flac
1089,M,test-clean,0,186480,186480,test-clean/1089/134686/1089-134686-0024.flac
8230,M,test-clean,0,187040,187040,test-clean/8230/279154/8230-279154-0033.flac
1089,M,test-clean,0,187120,187120,test-clean/1089/134691/1089-134691-0017.flac
7729,M,test-clean,0,188160,188160,test-clean/7729/102255/7729-102255-0040.flac
1284,F,test-clean,0,188400,188400,test-clean/1284/1181/1284-1181-0017.flac
7729,M,test-clean,0,188720,188720,test-clean/7729/102255/7729-102255-0022.flac
4992,F,test-clean,0,189120,189120,test-clean/4992/41806/4992-41806-0008.flac
7021,M,test-clean,3072,192400,189328,test-clean/7021/79740/7021-79740-0010.flac
8455,M,test-clean,0,189360,189360,test-clean/8455/210777/8455-210777-0008.flac
4970,F,test-clean,1536,190976,189440,test-clean/4970/29095/4970-29095-0020.flac
8230,M,test-clean,0,189520,189520,test-clean/8230/279154/8230-279154-0018.flac
3575,F,test-clean,0,189600,189600,test-clean/3575/170457/3575-170457-0055.flac
2961,F,test-clean,0,189760,189760,test-clean/2961/960/2961-960-0009.flac
5142,F,test-clean,0,190160,190160,test-clean/5142/36377/5142-36377-0025.flac
4077,M,test-clean,0,190320,190320,test-clean/4077/13754/4077-13754-0016.flac
3575,F,test-clean,0,191120,191120,test-clean/3575/170457/3575-170457-0053.flac
4077,M,test-clean,0,191280,191280,test-clean/4077/13754/4077-13754-0010.flac
237,F,test-clean,0,191440,191440,test-clean/237/126133/237-126133-0001.flac
260,M,test-clean,5120,196608,191488,test-clean/260/123288/260-123288-0005.flac
7021,M,test-clean,0,191488,191488,test-clean/7021/85628/7021-85628-0013.flac
1221,F,test-clean,0,191760,191760,test-clean/1221/135767/1221-135767-0013.flac
5683,F,test-clean,0,191840,191840,test-clean/5683/32879/5683-32879-0006.flac
5639,M,test-clean,4096,196000,191904,test-clean/5639/40744/5639-40744-0028.flac
1284,F,test-clean,0,192080,192080,test-clean/1284/1180/1284-1180-0018.flac
4446,F,test-clean,0,192160,192160,test-clean/4446/2271/4446-2271-0004.flac
4077,M,test-clean,0,192240,192240,test-clean/4077/13751/4077-13751-0012.flac
6930,M,test-clean,0,192240,192240,test-clean/6930/81414/6930-81414-0009.flac
3570,F,test-clean,1024,193360,192336,test-clean/3570/5694/3570-5694-0000.flac
4970,F,test-clean,0,192400,192400,test-clean/4970/29095/4970-29095-0033.flac
8555,F,test-clean,0,192640,192640,test-clean/8555/284449/8555-284449-0000.flac
5639,M,test-clean,6656,199600,192944,test-clean/5639/40744/5639-40744-0004.flac
5639,M,test-clean,0,192960,192960,test-clean/5639/40744/5639-40744-0019.flac
4507,F,test-clean,0,193120,193120,test-clean/4507/16021/4507-16021-0023.flac
5639,M,test-clean,3584,197120,193536,test-clean/5639/40744/5639-40744-0040.flac
2961,F,test-clean,0,194080,194080,test-clean/2961/960/2961-960-0019.flac
4077,M,test-clean,0,194400,194400,test-clean/4077/13751/4077-13751-0009.flac
3729,F,test-clean,0,195120,195120,test-clean/3729/6852/3729-6852-0001.flac
3575,F,test-clean,0,195360,195360,test-clean/3575/170457/3575-170457-0042.flac
2300,M,test-clean,0,195584,195584,test-clean/2300/131720/2300-131720-0018.flac
2961,F,test-clean,0,196080,196080,test-clean/2961/961/2961-961-0019.flac
3575,F,test-clean,0,196080,196080,test-clean/3575/170457/3575-170457-0024.flac
1320,M,test-clean,0,196160,196160,test-clean/1320/122617/1320-122617-0004.flac
4446,F,test-clean,0,196160,196160,test-clean/4446/2271/4446-2271-0017.flac
7127,M,test-clean,0,197280,197280,test-clean/7127/75946/7127-75946-0017.flac
7127,M,test-clean,0,197600,197600,test-clean/7127/75947/7127-75947-0022.flac
2300,M,test-clean,7168,204800,197632,test-clean/2300/131720/2300-131720-0002.flac
1320,M,test-clean,0,197920,197920,test-clean/1320/122617/1320-122617-0036.flac
6930,M,test-clean,0,198480,198480,test-clean/6930/76324/6930-76324-0015.flac
7729,M,test-clean,0,198640,198640,test-clean/7729/102255/7729-102255-0041.flac
7021,M,test-clean,0,198656,198656,test-clean/7021/79730/7021-79730-0007.flac
1221,F,test-clean,0,198960,198960,test-clean/1221/135766/1221-135766-0000.flac
5639,M,test-clean,0,199040,199040,test-clean/5639/40744/5639-40744-0001.flac
4992,F,test-clean,0,199040,199040,test-clean/4992/41806/4992-41806-0015.flac
4446,F,test-clean,0,199040,199040,test-clean/4446/2273/4446-2273-0010.flac
1089,M,test-clean,0,199120,199120,test-clean/1089/134686/1089-134686-0011.flac
5105,M,test-clean,0,199280,199280,test-clean/5105/28240/5105-28240-0021.flac
1995,F,test-clean,0,199360,199360,test-clean/1995/1837/1995-1837-0014.flac
6829,F,test-clean,0,199520,199520,test-clean/6829/68771/6829-68771-0012.flac
7021,M,test-clean,0,199680,199680,test-clean/7021/79730/7021-79730-0009.flac
3570,F,test-clean,0,199680,199680,test-clean/3570/5694/3570-5694-0009.flac
3729,F,test-clean,0,199840,199840,test-clean/3729/6852/3729-6852-0007.flac
7176,M,test-clean,0,201680,201680,test-clean/7176/88083/7176-88083-0021.flac
3729,F,test-clean,0,201680,201680,test-clean/3729/6852/3729-6852-0046.flac
4077,M,test-clean,0,201760,201760,test-clean/4077/13751/4077-13751-0014.flac
1188,M,test-clean,0,201760,201760,test-clean/1188/133604/1188-133604-0003.flac
908,M,test-clean,0,201920,201920,test-clean/908/157963/908-157963-0000.flac
8455,M,test-clean,0,202000,202000,test-clean/8455/210777/8455-210777-0027.flac
5639,M,test-clean,2560,204800,202240,test-clean/5639/40744/5639-40744-0034.flac
8224,M,test-clean,0,202480,202480,test-clean/8224/274381/8224-274381-0015.flac
1284,F,test-clean,0,202560,202560,test-clean/1284/1181/1284-1181-0013.flac
8230,M,test-clean,0,202640,202640,test-clean/8230/279154/8230-279154-0031.flac
3575,F,test-clean,0,203520,203520,test-clean/3575/170457/3575-170457-0039.flac
1221,F,test-clean,0,203520,203520,test-clean/1221/135767/1221-135767-0021.flac
3575,F,test-clean,0,203680,203680,test-clean/3575/170457/3575-170457-0017.flac
8555,F,test-clean,3072,206880,203808,test-clean/8555/284447/8555-284447-0010.flac
4077,M,test-clean,0,203999,203999,test-clean/4077/13754/4077-13754-0006.flac
5105,M,test-clean,0,204080,204080,test-clean/5105/28241/5105-28241-0017.flac
237,F,test-clean,0,204240,204240,test-clean/237/134493/237-134493-0003.flac
6829,F,test-clean,0,204288,204288,test-clean/6829/68771/6829-68771-0009.flac
1221,F,test-clean,0,204320,204320,test-clean/1221/135767/1221-135767-0007.flac
1995,F,test-clean,0,205200,205200,test-clean/1995/1837/1995-1837-0018.flac
5105,M,test-clean,0,205280,205280,test-clean/5105/28241/5105-28241-0018.flac
7021,M,test-clean,512,205824,205312,test-clean/7021/79759/7021-79759-0005.flac
1284,F,test-clean,0,205360,205360,test-clean/1284/134647/1284-134647-0004.flac
8455,M,test-clean,0,205520,205520,test-clean/8455/210777/8455-210777-0030.flac
237,F,test-clean,0,205520,205520,test-clean/237/134500/237-134500-0018.flac
3570,F,test-clean,2560,208080,205520,test-clean/3570/5694/3570-5694-0010.flac
2094,F,test-clean,0,205840,205840,test-clean/2094/142345/2094-142345-0033.flac
4077,M,test-clean,0,205920,205920,test-clean/4077/13754/4077-13754-0013.flac
6930,M,test-clean,0,206320,206320,test-clean/6930/81414/6930-81414-0000.flac
8463,F,test-clean,0,206720,206720,test-clean/8463/287645/8463-287645-0002.flac
8555,F,test-clean,0,207280,207280,test-clean/8555/284447/8555-284447-0006.flac
8463,F,test-clean,0,207360,207360,test-clean/8463/294828/8463-294828-0007.flac
2094,F,test-clean,0,207920,207920,test-clean/2094/142345/2094-142345-0014.flac
2961,F,test-clean,0,208240,208240,test-clean/2961/961/2961-961-0012.flac
3570,F,test-clean,0,208400,208400,test-clean/3570/5696/3570-5696-0005.flac
672,M,test-clean,0,208560,208560,test-clean/672/122797/672-122797-0067.flac
4077,M,test-clean,0,209040,209040,test-clean/4077/13751/4077-13751-0006.flac
8224,M,test-clean,0,209360,209360,test-clean/8224/274381/8224-274381-0003.flac
8463,F,test-clean,0,210240,210240,test-clean/8463/294828/8463-294828-0038.flac
260,M,test-clean,4608,215120,210512,test-clean/260/123288/260-123288-0025.flac
6930,M,test-clean,0,210560,210560,test-clean/6930/75918/6930-75918-0005.flac
8555,F,test-clean,0,210800,210800,test-clean/8555/284447/8555-284447-0021.flac
5639,M,test-clean,6656,217600,210944,test-clean/5639/40744/5639-40744-0022.flac
7127,M,test-clean,0,211040,211040,test-clean/7127/75946/7127-75946-0002.flac
4992,F,test-clean,0,211120,211120,test-clean/4992/41797/4992-41797-0009.flac
3729,F,test-clean,0,211440,211440,test-clean/3729/6852/3729-6852-0020.flac
4970,F,test-clean,5632,217600,211968,test-clean/4970/29095/4970-29095-0001.flac
5683,F,test-clean,0,212160,212160,test-clean/5683/32866/5683-32866-0009.flac
1089,M,test-clean,0,212400,212400,test-clean/1089/134686/1089-134686-0023.flac
7176,M,test-clean,0,212480,212480,test-clean/7176/92135/7176-92135-0043.flac
237,F,test-clean,0,212640,212640,test-clean/237/126133/237-126133-0000.flac
2300,M,test-clean,0,212992,212992,test-clean/2300/131720/2300-131720-0007.flac
5639,M,test-clean,4096,217088,212992,test-clean/5639/40744/5639-40744-0023.flac
6829,F,test-clean,0,213040,213040,test-clean/6829/68771/6829-68771-0000.flac
8555,F,test-clean,0,213360,213360,test-clean/8555/284449/8555-284449-0017.flac
1221,F,test-clean,0,213440,213440,test-clean/1221/135767/1221-135767-0009.flac
2300,M,test-clean,0,213504,213504,test-clean/2300/131720/2300-131720-0022.flac
4970,F,test-clean,8704,222208,213504,test-clean/4970/29093/4970-29093-0010.flac
1089,M,test-clean,0,213920,213920,test-clean/1089/134691/1089-134691-0021.flac
8224,M,test-clean,0,214720,214720,test-clean/8224/274384/8224-274384-0008.flac
1221,F,test-clean,0,214880,214880,test-clean/1221/135767/1221-135767-0001.flac
121,F,test-clean,7680,223232,215552,test-clean/121/127105/121-127105-0035.flac
4077,M,test-clean,0,215600,215600,test-clean/4077/13751/4077-13751-0015.flac
1320,M,test-clean,0,215680,215680,test-clean/1320/122612/1320-122612-0000.flac
3575,F,test-clean,0,216880,216880,test-clean/3575/170457/3575-170457-0008.flac
1320,M,test-clean,0,217360,217360,test-clean/1320/122617/1320-122617-0002.flac
5105,M,test-clean,0,217520,217520,test-clean/5105/28233/5105-28233-0010.flac
8224,M,test-clean,0,217760,217760,test-clean/8224/274381/8224-274381-0013.flac
672,M,test-clean,0,217920,217920,test-clean/672/122797/672-122797-0002.flac
8224,M,test-clean,0,217920,217920,test-clean/8224/274381/8224-274381-0010.flac
3729,F,test-clean,0,218240,218240,test-clean/3729/6852/3729-6852-0032.flac
1320,M,test-clean,0,219120,219120,test-clean/1320/122612/1320-122612-0011.flac
121,F,test-clean,2048,221184,219136,test-clean/121/127105/121-127105-0027.flac
5105,M,test-clean,0,219360,219360,test-clean/5105/28241/5105-28241-0011.flac
1221,F,test-clean,0,219520,219520,test-clean/1221/135766/1221-135766-0003.flac
2300,M,test-clean,1536,221184,219648,test-clean/2300/131720/2300-131720-0013.flac
8555,F,test-clean,6656,226816,220160,test-clean/8555/292519/8555-292519-0003.flac
7127,M,test-clean,0,220640,220640,test-clean/7127/75947/7127-75947-0040.flac
5639,M,test-clean,0,220800,220800,test-clean/5639/40744/5639-40744-0038.flac
2094,F,test-clean,0,221120,221120,test-clean/2094/142345/2094-142345-0006.flac
2300,M,test-clean,6656,228352,221696,test-clean/2300/131720/2300-131720-0001.flac
5105,M,test-clean,0,222080,222080,test-clean/5105/28240/5105-28240-0006.flac
1221,F,test-clean,0,222160,222160,test-clean/1221/135767/1221-135767-0012.flac
1089,M,test-clean,0,222320,222320,test-clean/1089/134686/1089-134686-0019.flac
8555,F,test-clean,0,222400,222400,test-clean/8555/284449/8555-284449-0004.flac
1188,M,test-clean,0,222880,222880,test-clean/1188/133604/1188-133604-0019.flac
121,F,test-clean,6656,229680,223024,test-clean/121/127105/121-127105-0020.flac
4077,M,test-clean,0,223200,223200,test-clean/4077/13754/4077-13754-0007.flac
672,M,test-clean,0,223200,223200,test-clean/672/122797/672-122797-0006.flac
672,M,test-clean,0,223360,223360,test-clean/672/122797/672-122797-0026.flac
8455,M,test-clean,0,223360,223360,test-clean/8455/210777/8455-210777-0051.flac
672,M,test-clean,0,223360,223360,test-clean/672/122797/672-122797-0045.flac
3570,F,test-clean,0,223744,223744,test-clean/3570/5694/3570-5694-0020.flac
908,M,test-clean,0,223840,223840,test-clean/908/157963/908-157963-0004.flac
3575,F,test-clean,0,224160,224160,test-clean/3575/170457/3575-170457-0041.flac
3570,F,test-clean,0,224256,224256,test-clean/3570/5694/3570-5694-0016.flac
1188,M,test-clean,0,224320,224320,test-clean/1188/133604/1188-133604-0021.flac
1320,M,test-clean,0,224880,224880,test-clean/1320/122617/1320-122617-0001.flac
8230,M,test-clean,0,224960,224960,test-clean/8230/279154/8230-279154-0004.flac
908,M,test-clean,0,225600,225600,test-clean/908/31957/908-31957-0022.flac
5639,M,test-clean,1536,227328,225792,test-clean/5639/40744/5639-40744-0026.flac
7021,M,test-clean,0,225792,225792,test-clean/7021/79740/7021-79740-0014.flac
4077,M,test-clean,0,226080,226080,test-clean/4077/13754/4077-13754-0011.flac
121,F,test-clean,2560,228864,226304,test-clean/121/127105/121-127105-0024.flac
4970,F,test-clean,3584,229888,226304,test-clean/4970/29095/4970-29095-0007.flac
3570,F,test-clean,5632,232080,226448,test-clean/3570/5694/3570-5694-0006.flac
1284,F,test-clean,0,226720,226720,test-clean/1284/134647/1284-134647-0007.flac
3575,F,test-clean,0,227200,227200,test-clean/3575/170457/3575-170457-0037.flac
2300,M,test-clean,6144,233472,227328,test-clean/2300/131720/2300-131720-0019.flac
5639,M,test-clean,0,227328,227328,test-clean/5639/40744/5639-40744-0039.flac
6930,M,test-clean,0,227600,227600,test-clean/6930/75918/6930-75918-0001.flac
1188,M,test-clean,0,227840,227840,test-clean/1188/133604/1188-133604-0007.flac
2094,F,test-clean,0,228000,228000,test-clean/2094/142345/2094-142345-0013.flac
7176,M,test-clean,0,228800,228800,test-clean/7176/88083/7176-88083-0007.flac
4507,F,test-clean,0,228960,228960,test-clean/4507/16021/4507-16021-0031.flac
4992,F,test-clean,0,229040,229040,test-clean/4992/23283/4992-23283-0017.flac
4992,F,test-clean,0,229760,229760,test-clean/4992/41806/4992-41806-0000.flac
8555,F,test-clean,3072,232960,229888,test-clean/8555/292519/8555-292519-0000.flac
260,M,test-clean,0,229888,229888,test-clean/260/123288/260-123288-0024.flac
1221,F,test-clean,0,230320,230320,test-clean/1221/135767/1221-135767-0022.flac
6930,M,test-clean,0,230400,230400,test-clean/6930/75918/6930-75918-0020.flac
2094,F,test-clean,0,230480,230480,test-clean/2094/142345/2094-142345-0009.flac
3575,F,test-clean,0,230800,230800,test-clean/3575/170457/3575-170457-0015.flac
4970,F,test-clean,8192,239104,230912,test-clean/4970/29093/4970-29093-0003.flac
7176,M,test-clean,0,231040,231040,test-clean/7176/92135/7176-92135-0000.flac
908,M,test-clean,0,231440,231440,test-clean/908/157963/908-157963-0015.flac
4507,F,test-clean,0,231680,231680,test-clean/4507/16021/4507-16021-0021.flac
8230,M,test-clean,0,232160,232160,test-clean/8230/279154/8230-279154-0034.flac
1188,M,test-clean,0,232160,232160,test-clean/1188/133604/1188-133604-0037.flac
4077,M,test-clean,0,232240,232240,test-clean/4077/13751/4077-13751-0016.flac
8230,M,test-clean,0,232960,232960,test-clean/8230/279154/8230-279154-0013.flac
260,M,test-clean,2048,235440,233392,test-clean/260/123440/260-123440-0002.flac
5683,F,test-clean,0,233440,233440,test-clean/5683/32879/5683-32879-0017.flac
2300,M,test-clean,8192,241664,233472,test-clean/2300/131720/2300-131720-0025.flac
5105,M,test-clean,0,233520,233520,test-clean/5105/28233/5105-28233-0009.flac
8224,M,test-clean,0,233600,233600,test-clean/8224/274384/8224-274384-0010.flac
1188,M,test-clean,0,234400,234400,test-clean/1188/133604/1188-133604-0012.flac
4970,F,test-clean,0,234720,234720,test-clean/4970/29095/4970-29095-0028.flac
2830,M,test-clean,0,234800,234800,test-clean/2830/3979/2830-3979-0007.flac
2094,F,test-clean,0,234800,234800,test-clean/2094/142345/2094-142345-0003.flac
3570,F,test-clean,0,235440,235440,test-clean/3570/5695/3570-5695-0001.flac
908,M,test-clean,0,236080,236080,test-clean/908/31957/908-31957-0004.flac
3570,F,test-clean,0,236160,236160,test-clean/3570/5695/3570-5695-0012.flac
4507,F,test-clean,0,236640,236640,test-clean/4507/16021/4507-16021-0030.flac
5105,M,test-clean,0,236960,236960,test-clean/5105/28233/5105-28233-0003.flac
4970,F,test-clean,3072,240640,237568,test-clean/4970/29095/4970-29095-0031.flac
8230,M,test-clean,0,239120,239120,test-clean/8230/279154/8230-279154-0041.flac
8463,F,test-clean,0,239280,239280,test-clean/8463/294828/8463-294828-0035.flac
1089,M,test-clean,0,239760,239760,test-clean/1089/134691/1089-134691-0008.flac
7729,M,test-clean,0,239840,239840,test-clean/7729/102255/7729-102255-0015.flac
7176,M,test-clean,0,240000,240000,test-clean/7176/88083/7176-88083-0013.flac
2094,F,test-clean,0,240240,240240,test-clean/2094/142345/2094-142345-0015.flac
1284,F,test-clean,0,240400,240400,test-clean/1284/1180/1284-1180-0019.flac
5683,F,test-clean,0,240480,240480,test-clean/5683/32866/5683-32866-0010.flac
1089,M,test-clean,0,240480,240480,test-clean/1089/134691/1089-134691-0012.flac
1221,F,test-clean,0,240800,240800,test-clean/1221/135766/1221-135766-0010.flac
7729,M,test-clean,0,240960,240960,test-clean/7729/102255/7729-102255-0026.flac
8455,M,test-clean,0,241040,241040,test-clean/8455/210777/8455-210777-0036.flac
1284,F,test-clean,0,241760,241760,test-clean/1284/134647/1284-134647-0002.flac
7729,M,test-clean,0,241760,241760,test-clean/7729/102255/7729-102255-0017.flac
5639,M,test-clean,4608,246639,242031,test-clean/5639/40744/5639-40744-0018.flac
672,M,test-clean,0,242080,242080,test-clean/672/122797/672-122797-0001.flac
3729,F,test-clean,0,242640,242640,test-clean/3729/6852/3729-6852-0042.flac
4507,F,test-clean,0,242640,242640,test-clean/4507/16021/4507-16021-0010.flac
1995,F,test-clean,1536,244224,242688,test-clean/1995/1826/1995-1826-0026.flac
1188,M,test-clean,0,243040,243040,test-clean/1188/133604/1188-133604-0011.flac
8230,M,test-clean,0,243040,243040,test-clean/8230/279154/8230-279154-0010.flac
4992,F,test-clean,0,243360,243360,test-clean/4992/41806/4992-41806-0014.flac
1188,M,test-clean,0,243840,243840,test-clean/1188/133604/1188-133604-0024.flac
1221,F,test-clean,0,244080,244080,test-clean/1221/135767/1221-135767-0016.flac
672,M,test-clean,0,244320,244320,test-clean/672/122797/672-122797-0064.flac
7021,M,test-clean,0,244640,244640,test-clean/7021/85628/7021-85628-0003.flac
672,M,test-clean,0,244960,244960,test-clean/672/122797/672-122797-0042.flac
2961,F,test-clean,0,245600,245600,test-clean/2961/960/2961-960-0002.flac
5639,M,test-clean,6144,252320,246176,test-clean/5639/40744/5639-40744-0000.flac
4507,F,test-clean,0,246720,246720,test-clean/4507/16021/4507-16021-0039.flac
5142,F,test-clean,0,246784,246784,test-clean/5142/36377/5142-36377-0008.flac
2961,F,test-clean,0,247280,247280,test-clean/2961/960/2961-960-0008.flac
2094,F,test-clean,0,248320,248320,test-clean/2094/142345/2094-142345-0002.flac
8455,M,test-clean,0,250320,250320,test-clean/8455/210777/8455-210777-0061.flac
1089,M,test-clean,0,251520,251520,test-clean/1089/134686/1089-134686-0018.flac
2961,F,test-clean,0,251600,251600,test-clean/2961/960/2961-960-0006.flac
7176,M,test-clean,0,251840,251840,test-clean/7176/92135/7176-92135-0025.flac
4992,F,test-clean,0,252160,252160,test-clean/4992/41806/4992-41806-0016.flac
2961,F,test-clean,0,252560,252560,test-clean/2961/960/2961-960-0021.flac
2300,M,test-clean,7680,261632,253952,test-clean/2300/131720/2300-131720-0003.flac
121,F,test-clean,3072,257040,253968,test-clean/121/127105/121-127105-0025.flac
2300,M,test-clean,0,254000,254000,test-clean/2300/131720/2300-131720-0011.flac
8230,M,test-clean,0,254480,254480,test-clean/8230/279154/8230-279154-0007.flac
8463,F,test-clean,0,255600,255600,test-clean/8463/287645/8463-287645-0005.flac
1320,M,test-clean,0,255920,255920,test-clean/1320/122617/1320-122617-0028.flac
7176,M,test-clean,0,256320,256320,test-clean/7176/92135/7176-92135-0014.flac
260,M,test-clean,0,256640,256640,test-clean/260/123288/260-123288-0026.flac
5105,M,test-clean,0,257040,257040,test-clean/5105/28240/5105-28240-0001.flac
7127,M,test-clean,0,257200,257200,test-clean/7127/75946/7127-75946-0028.flac
1188,M,test-clean,0,257360,257360,test-clean/1188/133604/1188-133604-0015.flac
2094,F,test-clean,0,257920,257920,test-clean/2094/142345/2094-142345-0030.flac
1221,F,test-clean,0,257920,257920,test-clean/1221/135767/1221-135767-0002.flac
2830,M,test-clean,0,258001,258001,test-clean/2830/3979/2830-3979-0001.flac
2300,M,test-clean,7168,265216,258048,test-clean/2300/131720/2300-131720-0031.flac
2094,F,test-clean,0,258080,258080,test-clean/2094/142345/2094-142345-0012.flac
121,F,test-clean,1536,260640,259104,test-clean/121/123852/121-123852-0004.flac
1221,F,test-clean,0,259520,259520,test-clean/1221/135766/1221-135766-0012.flac
1284,F,test-clean,0,259520,259520,test-clean/1284/1180/1284-1180-0030.flac
8455,M,test-clean,0,259839,259839,test-clean/8455/210777/8455-210777-0016.flac
2094,F,test-clean,0,260160,260160,test-clean/2094/142345/2094-142345-0011.flac
1221,F,test-clean,0,260320,260320,test-clean/1221/135767/1221-135767-0023.flac
6829,F,test-clean,0,260560,260560,test-clean/6829/68771/6829-68771-0007.flac
1089,M,test-clean,0,261280,261280,test-clean/1089/134691/1089-134691-0013.flac
8455,M,test-clean,0,261760,261760,test-clean/8455/210777/8455-210777-0022.flac
7176,M,test-clean,0,262400,262400,test-clean/7176/92135/7176-92135-0012.flac
3729,F,test-clean,0,263360,263360,test-clean/3729/6852/3729-6852-0004.flac
8230,M,test-clean,0,263600,263600,test-clean/8230/279154/8230-279154-0002.flac
1221,F,test-clean,0,264160,264160,test-clean/1221/135767/1221-135767-0011.flac
8555,F,test-clean,0,264320,264320,test-clean/8555/284449/8555-284449-0011.flac
2830,M,test-clean,0,264960,264960,test-clean/2830/3980/2830-3980-0073.flac
7176,M,test-clean,0,265200,265200,test-clean/7176/88083/7176-88083-0001.flac
7021,M,test-clean,1536,266800,265264,test-clean/7021/85628/7021-85628-0007.flac
1188,M,test-clean,0,265520,265520,test-clean/1188/133604/1188-133604-0016.flac
1221,F,test-clean,0,266320,266320,test-clean/1221/135766/1221-135766-0005.flac
1995,F,test-clean,3584,270336,266752,test-clean/1995/1837/1995-1837-0023.flac
4077,M,test-clean,0,266880,266880,test-clean/4077/13751/4077-13751-0004.flac
8230,M,test-clean,0,267120,267120,test-clean/8230/279154/8230-279154-0040.flac
5639,M,test-clean,5632,272896,267264,test-clean/5639/40744/5639-40744-0041.flac
1221,F,test-clean,0,267440,267440,test-clean/1221/135766/1221-135766-0001.flac
4077,M,test-clean,0,267520,267520,test-clean/4077/13751/4077-13751-0003.flac
1221,F,test-clean,0,267520,267520,test-clean/1221/135767/1221-135767-0017.flac
3575,F,test-clean,0,267760,267760,test-clean/3575/170457/3575-170457-0026.flac
3570,F,test-clean,0,267760,267760,test-clean/3570/5696/3570-5696-0001.flac
1089,M,test-clean,0,268640,268640,test-clean/1089/134686/1089-134686-0020.flac
6930,M,test-clean,0,269440,269440,test-clean/6930/75918/6930-75918-0014.flac
8230,M,test-clean,0,270560,270560,test-clean/8230/279154/8230-279154-0009.flac
121,F,test-clean,3072,273920,270848,test-clean/121/123859/121-123859-0000.flac
8224,M,test-clean,0,271680,271680,test-clean/8224/274381/8224-274381-0006.flac
7729,M,test-clean,0,272080,272080,test-clean/7729/102255/7729-102255-0006.flac
121,F,test-clean,3072,276560,273488,test-clean/121/123852/121-123852-0002.flac
7729,M,test-clean,0,273680,273680,test-clean/7729/102255/7729-102255-0044.flac
5639,M,test-clean,0,274432,274432,test-clean/5639/40744/5639-40744-0032.flac
121,F,test-clean,4608,279552,274944,test-clean/121/123852/121-123852-0000.flac
4077,M,test-clean,0,275520,275520,test-clean/4077/13751/4077-13751-0007.flac
2300,M,test-clean,5632,281680,276048,test-clean/2300/131720/2300-131720-0033.flac
4507,F,test-clean,0,276240,276240,test-clean/4507/16021/4507-16021-0016.flac
2961,F,test-clean,0,277040,277040,test-clean/2961/960/2961-960-0003.flac
8230,M,test-clean,0,278080,278080,test-clean/8230/279154/8230-279154-0001.flac
5105,M,test-clean,0,278640,278640,test-clean/5105/28241/5105-28241-0004.flac
5639,M,test-clean,1024,280320,279296,test-clean/5639/40744/5639-40744-0035.flac
2300,M,test-clean,0,279552,279552,test-clean/2300/131720/2300-131720-0026.flac
6930,M,test-clean,0,279760,279760,test-clean/6930/81414/6930-81414-0001.flac
7021,M,test-clean,4608,285696,281088,test-clean/7021/79730/7021-79730-0004.flac
5105,M,test-clean,0,281120,281120,test-clean/5105/28240/5105-28240-0023.flac
8463,F,test-clean,0,282240,282240,test-clean/8463/294825/8463-294825-0013.flac
8224,M,test-clean,0,283840,283840,test-clean/8224/274381/8224-274381-0000.flac
4992,F,test-clean,0,283920,283920,test-clean/4992/41806/4992-41806-0002.flac
4077,M,test-clean,0,284480,284480,test-clean/4077/13754/4077-13754-0002.flac
8224,M,test-clean,0,285200,285200,test-clean/8224/274381/8224-274381-0017.flac
4077,M,test-clean,0,285440,285440,test-clean/4077/13754/4077-13754-0005.flac
8224,M,test-clean,0,286080,286080,test-clean/8224/274381/8224-274381-0014.flac
1188,M,test-clean,0,287360,287360,test-clean/1188/133604/1188-133604-0002.flac
8555,F,test-clean,0,287440,287440,test-clean/8555/292519/8555-292519-0009.flac
7127,M,test-clean,0,287520,287520,test-clean/7127/75947/7127-75947-0000.flac
3729,F,test-clean,0,287840,287840,test-clean/3729/6852/3729-6852-0017.flac
7021,M,test-clean,5120,293376,288256,test-clean/7021/79740/7021-79740-0008.flac
8455,M,test-clean,0,290000,290000,test-clean/8455/210777/8455-210777-0001.flac
8230,M,test-clean,0,290320,290320,test-clean/8230/279154/8230-279154-0019.flac
1320,M,test-clean,0,291520,291520,test-clean/1320/122617/1320-122617-0035.flac
3729,F,test-clean,0,292960,292960,test-clean/3729/6852/3729-6852-0009.flac
1320,M,test-clean,0,296400,296400,test-clean/1320/122617/1320-122617-0007.flac
3729,F,test-clean,0,296640,296640,test-clean/3729/6852/3729-6852-0005.flac
1188,M,test-clean,0,296720,296720,test-clean/1188/133604/1188-133604-0044.flac
7729,M,test-clean,0,296960,296960,test-clean/7729/102255/7729-102255-0009.flac
1221,F,test-clean,0,298080,298080,test-clean/1221/135767/1221-135767-0003.flac
8224,M,test-clean,0,299680,299680,test-clean/8224/274384/8224-274384-0012.flac
8230,M,test-clean,0,300160,300160,test-clean/8230/279154/8230-279154-0042.flac
5142,F,test-clean,0,301920,301920,test-clean/5142/36377/5142-36377-0021.flac
3729,F,test-clean,0,302320,302320,test-clean/3729/6852/3729-6852-0034.flac
3570,F,test-clean,0,302592,302592,test-clean/3570/5694/3570-5694-0003.flac
2300,M,test-clean,8192,311808,303616,test-clean/2300/131720/2300-131720-0004.flac
3575,F,test-clean,0,304000,304000,test-clean/3575/170457/3575-170457-0043.flac
672,M,test-clean,0,304079,304079,test-clean/672/122797/672-122797-0022.flac
1188,M,test-clean,0,304080,304080,test-clean/1188/133604/1188-133604-0028.flac
7729,M,test-clean,0,305040,305040,test-clean/7729/102255/7729-102255-0008.flac
1221,F,test-clean,0,305440,305440,test-clean/1221/135767/1221-135767-0004.flac
4970,F,test-clean,0,310784,310784,test-clean/4970/29095/4970-29095-0021.flac
7127,M,test-clean,0,311600,311600,test-clean/7127/75946/7127-75946-0000.flac
8555,F,test-clean,3072,316081,313009,test-clean/8555/284447/8555-284447-0015.flac
4077,M,test-clean,0,313760,313760,test-clean/4077/13751/4077-13751-0005.flac
4077,M,test-clean,0,315280,315280,test-clean/4077/13751/4077-13751-0021.flac
2300,M,test-clean,3072,318640,315568,test-clean/2300/131720/2300-131720-0017.flac
7729,M,test-clean,0,316881,316881,test-clean/7729/102255/7729-102255-0003.flac
8224,M,test-clean,0,318160,318160,test-clean/8224/274381/8224-274381-0012.flac
4077,M,test-clean,0,318560,318560,test-clean/4077/13754/4077-13754-0008.flac
7729,M,test-clean,0,319120,319120,test-clean/7729/102255/7729-102255-0046.flac
908,M,test-clean,0,319200,319200,test-clean/908/157963/908-157963-0008.flac
2961,F,test-clean,0,319840,319840,test-clean/2961/961/2961-961-0002.flac
8463,F,test-clean,0,320079,320079,test-clean/8463/294825/8463-294825-0009.flac
1089,M,test-clean,0,320160,320160,test-clean/1089/134691/1089-134691-0011.flac
2300,M,test-clean,0,320240,320240,test-clean/2300/131720/2300-131720-0016.flac
3570,F,test-clean,0,320480,320480,test-clean/3570/5695/3570-5695-0005.flac
1089,M,test-clean,0,320880,320880,test-clean/1089/134691/1089-134691-0009.flac
1188,M,test-clean,0,322000,322000,test-clean/1188/133604/1188-133604-0026.flac
1284,F,test-clean,0,322320,322320,test-clean/1284/134647/1284-134647-0003.flac
7127,M,test-clean,0,322400,322400,test-clean/7127/75946/7127-75946-0026.flac
7729,M,test-clean,0,322480,322480,test-clean/7729/102255/7729-102255-0004.flac
5142,F,test-clean,0,322960,322960,test-clean/5142/36600/5142-36600-0001.flac
2094,F,test-clean,0,324000,324000,test-clean/2094/142345/2094-142345-0038.flac
7729,M,test-clean,0,324480,324480,test-clean/7729/102255/7729-102255-0032.flac
8224,M,test-clean,0,325280,325280,test-clean/8224/274384/8224-274384-0001.flac
7729,M,test-clean,0,325680,325680,test-clean/7729/102255/7729-102255-0011.flac
3729,F,test-clean,0,326000,326000,test-clean/3729/6852/3729-6852-0045.flac
2961,F,test-clean,0,327360,327360,test-clean/2961/960/2961-960-0010.flac
260,M,test-clean,8192,335872,327680,test-clean/260/123288/260-123288-0015.flac
8230,M,test-clean,0,328560,328560,test-clean/8230/279154/8230-279154-0037.flac
1221,F,test-clean,0,328960,328960,test-clean/1221/135767/1221-135767-0006.flac
908,M,test-clean,0,328960,328960,test-clean/908/31957/908-31957-0025.flac
8224,M,test-clean,0,330240,330240,test-clean/8224/274384/8224-274384-0004.flac
3729,F,test-clean,0,330400,330400,test-clean/3729/6852/3729-6852-0035.flac
8555,F,test-clean,2048,333120,331072,test-clean/8555/292519/8555-292519-0001.flac
1188,M,test-clean,0,332080,332080,test-clean/1188/133604/1188-133604-0008.flac
5683,F,test-clean,0,333680,333680,test-clean/5683/32866/5683-32866-0019.flac
2961,F,test-clean,0,334000,334000,test-clean/2961/960/2961-960-0011.flac
1188,M,test-clean,0,334480,334480,test-clean/1188/133604/1188-133604-0034.flac
8224,M,test-clean,0,335680,335680,test-clean/8224/274381/8224-274381-0008.flac
5105,M,test-clean,0,336240,336240,test-clean/5105/28241/5105-28241-0001.flac
8463,F,test-clean,0,336800,336800,test-clean/8463/294825/8463-294825-0007.flac
8224,M,test-clean,0,340080,340080,test-clean/8224/274381/8224-274381-0004.flac
1221,F,test-clean,0,341520,341520,test-clean/1221/135766/1221-135766-0011.flac
908,M,test-clean,0,343040,343040,test-clean/908/157963/908-157963-0019.flac
908,M,test-clean,0,343440,343440,test-clean/908/31957/908-31957-0015.flac
3729,F,test-clean,0,343680,343680,test-clean/3729/6852/3729-6852-0003.flac
8463,F,test-clean,0,344000,344000,test-clean/8463/287645/8463-287645-0007.flac
5683,F,test-clean,0,344160,344160,test-clean/5683/32865/5683-32865-0012.flac
5639,M,test-clean,6656,351232,344576,test-clean/5639/40744/5639-40744-0030.flac
4992,F,test-clean,0,347760,347760,test-clean/4992/23283/4992-23283-0012.flac
8230,M,test-clean,0,348480,348480,test-clean/8230/279154/8230-279154-0025.flac
4970,F,test-clean,0,348672,348672,test-clean/4970/29093/4970-29093-0005.flac
4077,M,test-clean,0,353520,353520,test-clean/4077/13754/4077-13754-0012.flac
4077,M,test-clean,0,355280,355280,test-clean/4077/13754/4077-13754-0015.flac
8224,M,test-clean,0,357760,357760,test-clean/8224/274384/8224-274384-0011.flac
8224,M,test-clean,0,359200,359200,test-clean/8224/274381/8224-274381-0001.flac
8230,M,test-clean,0,359840,359840,test-clean/8230/279154/8230-279154-0038.flac
4507,F,test-clean,0,360000,360000,test-clean/4507/16021/4507-16021-0020.flac
2094,F,test-clean,0,361120,361120,test-clean/2094/142345/2094-142345-0000.flac
5639,M,test-clean,6656,371200,364544,test-clean/5639/40744/5639-40744-0027.flac
7127,M,test-clean,0,365440,365440,test-clean/7127/75947/7127-75947-0009.flac
1188,M,test-clean,0,368960,368960,test-clean/1188/133604/1188-133604-0009.flac
6930,M,test-clean,0,373040,373040,test-clean/6930/75918/6930-75918-0003.flac
1284,F,test-clean,0,373361,373361,test-clean/1284/134647/1284-134647-0005.flac
121,F,test-clean,0,376080,376080,test-clean/121/123852/121-123852-0003.flac
1188,M,test-clean,0,378720,378720,test-clean/1188/133604/1188-133604-0023.flac
3729,F,test-clean,0,379840,379840,test-clean/3729/6852/3729-6852-0006.flac
3729,F,test-clean,0,381760,381760,test-clean/3729/6852/3729-6852-0008.flac
7021,M,test-clean,0,388608,388608,test-clean/7021/79759/7021-79759-0004.flac
1995,F,test-clean,1536,390656,389120,test-clean/1995/1836/1995-1836-0010.flac
8230,M,test-clean,0,391760,391760,test-clean/8230/279154/8230-279154-0043.flac
8224,M,test-clean,0,392640,392640,test-clean/8224/274381/8224-274381-0002.flac
2300,M,test-clean,7168,403968,396800,test-clean/2300/131720/2300-131720-0035.flac
1221,F,test-clean,0,397600,397600,test-clean/1221/135767/1221-135767-0000.flac
121,F,test-clean,6656,404480,397824,test-clean/121/123859/121-123859-0001.flac
3570,F,test-clean,0,401840,401840,test-clean/3570/5696/3570-5696-0003.flac
5142,F,test-clean,0,406640,406640,test-clean/5142/36377/5142-36377-0014.flac
3575,F,test-clean,0,410240,410240,test-clean/3575/170457/3575-170457-0046.flac
2300,M,test-clean,0,415040,415040,test-clean/2300/131720/2300-131720-0028.flac
2961,F,test-clean,0,415760,415760,test-clean/2961/961/2961-961-0022.flac
4077,M,test-clean,0,417840,417840,test-clean/4077/13751/4077-13751-0018.flac
5105,M,test-clean,0,418240,418240,test-clean/5105/28233/5105-28233-0007.flac
8224,M,test-clean,0,418560,418560,test-clean/8224/274381/8224-274381-0005.flac
5639,M,test-clean,5632,433920,428288,test-clean/5639/40744/5639-40744-0003.flac
2961,F,test-clean,0,434880,434880,test-clean/2961/960/2961-960-0000.flac
8224,M,test-clean,0,440400,440400,test-clean/8224/274381/8224-274381-0016.flac
5639,M,test-clean,4608,449536,444928,test-clean/5639/40744/5639-40744-0031.flac
4507,F,test-clean,0,449440,449440,test-clean/4507/16021/4507-16021-0032.flac
3575,F,test-clean,0,452320,452320,test-clean/3575/170457/3575-170457-0036.flac
4992,F,test-clean,0,454560,454560,test-clean/4992/41797/4992-41797-0001.flac
8224,M,test-clean,0,454560,454560,test-clean/8224/274381/8224-274381-0009.flac
3729,F,test-clean,0,457200,457200,test-clean/3729/6852/3729-6852-0033.flac
4970,F,test-clean,7680,469504,461824,test-clean/4970/29093/4970-29093-0006.flac
5105,M,test-clean,0,466240,466240,test-clean/5105/28241/5105-28241-0015.flac
121,F,test-clean,0,476672,476672,test-clean/121/123859/121-123859-0002.flac
2094,F,test-clean,0,489840,489840,test-clean/2094/142345/2094-142345-0010.flac
672,M,test-clean,0,492960,492960,test-clean/672/122797/672-122797-0008.flac
4507,F,test-clean,0,505840,505840,test-clean/4507/16021/4507-16021-0026.flac
2094,F,test-clean,0,506400,506400,test-clean/2094/142345/2094-142345-0008.flac
908,M,test-clean,0,524320,524320,test-clean/908/157963/908-157963-0007.flac
7021,M,test-clean,0,525824,525824,test-clean/7021/79730/7021-79730-0003.flac
1995,F,test-clean,3072,536064,532992,test-clean/1995/1836/1995-1836-0004.flac
4507,F,test-clean,0,559280,559280,test-clean/4507/16021/4507-16021-0047.flac
